,name,code,per,roe,per_sort,roe_sort,sort
2335,양지사,030960,1.28,93.94,6,1,7
508,이글루시큐리티,067920,10.72,9.97,48,5,53
2074,제룡산업,147830,10.3,9.62,30,28,58
1391,삼영엠텍,054540,10.18,9.14,23,53,76
1995,서플러스글로벌,140070,10.12,8.98,18,63,81
121,대한약품,023910,11.37,9.97,88,6,94
602,HDC아이콘트롤스,039570,11.03,9.42,68,33,101
195,오공,045060,11.09,9.29,71,42,113
454,삼진,032750,10.16,8.36,20,97,117
2254,SGC이테크건설,016250,1.16,79.74,5,120,125
278,희림,037440,11.07,8.97,70,64,134
2417,포시에스,189690,12.0,9.79,127,14,141
2341,에스텍,069510,10.11,7.84,17,133,150
915,LIG넥스원,079550,11.59,8.86,92,71,163
996,퍼시스,016800,10.01,7.53,13,152,165
1312,한솔테크닉스,004710,12.43,9.7,148,21,169
2187,씨에스윈드,112610,104.75,8.19,62,111,173
1424,에스피지,058610,12.9,9.71,171,19,190
1225,LG,003550,10.5,7.5,38,157,195
366,태영건설,009410,1.4,61.96,7,196,203
1921,한국단자공업,025540,11.21,7.84,80,131,211
845,인탑스,049070,12.84,8.95,168,66,234
510,이녹스,088390,11.82,7.54,104,150,254
27,두산인프라코어,042670,10.27,6.47,27,234,261
1462,이상네트웍스,080010,10.22,6.38,24,244,268
1343,게임빌,063080,12.01,7.68,129,144,273
1003,한미글로벌,053690,12.31,7.84,144,132,276
773,성우테크론,045300,11.89,7.35,108,169,277
1043,대양전기공업,108380,10.69,6.48,46,233,279
1479,젬백스링크,064800,11.13,6.89,75,207,282
1138,원익,032940,1.09,54.23,4,284,288
1547,LG유플러스,032640,10.99,6.46,56,235,291
1604,지투알,035000,10.45,6.27,37,254,291
1235,고려아연,010130,13.22,8.37,196,95,291
351,우리금융캐피탈,033660,11.9,7.19,110,182,292
1858,농심,004370,12.29,7.5,143,155,298
624,대한유화,006650,11.75,6.93,97,204,301
384,환인제약,016580,13.28,8.21,203,104,307
558,파인디지털,038950,11.94,6.96,115,200,315
2058,이노인스트루먼트,215790,14.73,9.38,282,36,318
2358,오로라,039830,12.61,7.41,157,165,322
225,제주반도체,080220,15.26,9.72,307,18,325
1004,한솔피엔에스,010420,12.01,6.97,130,199,329
2393,지에스이,053050,11.26,6.14,83,265,348
312,금호건설,002990,12.63,6.89,158,206,364
2310,서전기전,189860,12.09,6.53,135,229,364
18,국도화학,007690,10.66,5.54,44,329,373
1233,SNT모티브,064960,13.27,7.27,200,173,373
1398,성도이엔지,037350,0.79,48.53,2,374,376
1691,비덴트,121800,13.29,7.25,204,174,378
88,현대엘리베이터,017800,16.77,9.78,366,15,381
1025,SNK,950180,12.95,6.86,173,208,381
184,엑세스바이오,950130,15.75,89.16,323,62,385
682,조선선재,120030,14.63,8.09,272,114,386
1,DSR,155660,11.2,5.67,79,314,393
939,두산밥캣,241560,12.01,6.15,131,263,394
612,SK텔레콤,017670,12.77,6.44,163,237,400
460,서호전기,065710,16.48,9.15,358,51,409
1928,한전KPS,051600,15.35,8.23,312,101,413
1802,피씨엘,241820,18.05,91.65,413,2,415
2222,풍산,103140,10.89,5.09,55,362,417
1238,노루페인트,090350,11.28,5.48,84,334,418
1354,넷게임즈,225570,10.8,49.93,52,373,425
529,지니언스,263860,18.18,9.96,421,7,428
1330,KG모빌리언스,046440,17.21,9.16,385,49,434
956,삼양사,145990,11.19,5.06,78,365,443
2334,야스,255440,14.93,7.51,290,154,444
1232,SK하이닉스,000660,18.14,9.53,419,29,448
696,한국석유공업,004090,10.24,4.59,26,422,448
1316,현대리바트,079430,12.32,5.66,145,315,460
1240,대성에너지,117580,10.37,4.55,33,427,460
1906,일양약품,007570,118.12,5.38,124,338,462
299,GS리테일,007070,15.75,7.5,322,156,478
1788,태양,053620,10.39,4.35,36,444,480
1115,에이프로젠 H&G,109960,11.96,5.01,116,370,486
659,송원산업,004430,13.94,6.17,225,261,486
436,메디앙스,014100,11.74,4.95,96,391,487
2280,동일금속,109860,12.17,5.26,139,349,488
221,제우스,079370,16.67,7.81,363,134,497
1813,화신정공,126640,13.2,5.79,194,304,498
1744,오디텍,080520,11.23,4.61,81,421,502
880,파버나인,177830,16.51,7.64,360,146,506
1915,파미셀,005690,197.89,9.65,481,25,506
427,레드캡투어,038390,14.87,6.67,287,220,507
627,도화엔지니어링,002150,15.41,7.0,316,192,508
2201,유수홀딩스,000700,1.87,30.04,12,504,516
138,바디텍메드,206640,12.23,47.04,141,375,516
709,한화에어로스페이스,012450,11.93,4.78,112,405,517
1352,네오오토,212560,11.18,4.37,77,442,519
670,에스엘,005850,11.93,4.74,113,407,520
937,동화약품,000020,19.25,9.04,466,60,526
46,세방전지,004490,14.56,6.13,267,267,534
1308,한독,002390,17.0,7.47,377,161,538
1571,동양철관,008970,18.92,8.41,448,91,539
1088,슈프리마에이치큐,094840,11.81,4.49,103,436,539
69,조흥,002600,13.97,5.72,230,309,539
985,이노션,214320,18.78,8.28,443,99,542
1319,혜인,003010,12.56,4.97,155,388,543
954,삼성전자,005930,21.09,9.98,539,4,543
40,삼성화재해상보험,000810,12.56,4.96,154,390,544
374,한국타이어앤테크놀로지,161390,13.11,5.12,189,357,546
1400,세원물산,024830,2.86,9.28,504,43,547
1897,오리온홀딩스,001800,10.67,3.98,45,506,551
991,참엔지니어링,009310,16.95,7.18,373,184,557
1929,한화시스템,272210,20.4,9.35,520,39,559
1869,동아타이어,282690,10.17,3.69,22,537,559
106,까스텔바작,308100,14.92,6.06,289,273,562
416,대주전자재료,078600,140.54,6.12,293,270,563
2196,영풍제지,006740,16.59,6.94,361,202,563
345,아이마켓코리아,122900,14.59,5.87,268,296,564
1477,제이씨케미칼,137950,18.97,8.03,449,117,566
1345,골든센츄리,900280,2.29,8.68,489,79,568
1249,백광산업,001340,14.68,5.89,275,294,569
677,이마트,139480,11.67,4.05,94,475,569
2159,노루홀딩스,000320,10.54,3.8,39,530,569
5,KG동부제철,016380,17.37,7.18,387,183,570
628,동방아그로,007590,12.97,4.83,175,398,573
1359,다날,064260,18.91,7.87,446,129,575
1378,메가엠디,133750,19.34,8.21,471,105,576
1169,타이거일렉,219130,21.41,9.63,550,27,577
7,KTis,058860,12.13,4.4,137,440,577
1009,한화,000880,12.96,4.79,174,403,577
410,넵튠,217270,13.51,49.96,211,372,583
1418,아즈텍WB,032080,10.8,3.76,51,533,584
2426,하츠,066130,17.77,7.03,395,191,586
2007,아미노로직스,074430,110.4,4.06,120,474,594
922,SNT에너지,100840,12.0,4.07,128,468,596
1631,화승엔터프라이즈,241590,21.44,9.26,553,45,598
2278,도이치모터스,067990,14.56,5.48,266,333,599
1678,멀티캠퍼스,067280,20.41,8.76,522,77,599
1854,고려산업,002140,17.83,6.91,397,205,602
55,오뚜기,007310,19.7,7.93,477,125,602
784,스포츠서울,039670,13.75,4308.4,220,382,602
2234,현대그린푸드,005440,12.03,4.07,133,469,602
1050,디바이스이엔지,187870,11.97,37.44,117,486,603
2269,뉴트리,270870,11.78,30.0,101,505,606
1987,베뉴지,019010,10.39,3.35,34,574,608
150,솔고바이오,043100,13.75,4.91,219,393,612
1076,비에이치아이,083650,14.71,5.4,280,336,616
697,한국수출포장공업,002200,10.58,3.34,41,575,616
1434,에코바이오,038870,20.72,8.42,528,89,617
2153,계양전기,012200,14.7,5.3,279,346,625
1501,팅크웨어,084730,15.09,5.56,301,324,625
1047,덕산하이메탈,077360,19.04,7.28,454,172,626
332,빙그레,005180,16.13,6.01,346,280,626
1581,삼익악기,002450,13.17,4.49,193,435,628
2405,코콤,015710,16.43,6.06,355,275,630
1053,라이온켐텍,171120,18.54,6.99,435,198,633
2397,청담러닝,096240,22.78,9.22,590,47,637
2155,그린케미칼,083420,23.14,9.33,604,40,644
712,휴니드테크놀러지스,005870,14.08,4.86,248,397,645
179,에이디테크놀로지,200710,106.66,3.23,63,583,646
99,YW,051390,13.82,4.55,221,426,647
2401,코렌텍,104540,124.77,4.12,182,466,648
1811,핸디소프트,220180,16.85,6.04,372,277,649
2425,하이비젼시스템,126700,21.11,8.2,542,107,649
1060,메가스터디교육,215200,21.47,8.38,555,94,649
334,사조동아원,008040,14.1,4.74,249,408,657
2139,BYC,001460,13.16,4.12,192,467,659
2380,인터로조,119610,22.22,8.67,579,80,659
828,원풍,008370,14.62,4.89,270,395,665
1237,남해화학,025860,16.29,5.65,350,317,667
1481,줌인터넷,239340,132.69,4.49,234,434,668
319,대원제약,003220,22.27,8.42,581,90,671
1141,유성티엔에스,024800,1.65,22.19,8,663,671
731,넥슨지티,041140,118.15,3.61,125,547,672
1447,와이엠씨,155650,23.48,9.1,617,57,674
567,픽셀플러스,087600,15.26,5.03,306,368,674
2088,케이프,064820,16.34,5.59,353,321,674
1694,비츠로셀,082920,25.15,9.5,651,30,681
2386,제이브이엠,054950,21.81,8.0,563,119,682
936,동국제강,001230,11.9,3.35,111,573,684
2266,녹십자랩셀,144510,233.66,9.12,630,54,684
663,신세계인터내셔날,031430,22.65,8.24,586,100,686
31,롯데정보통신,286940,20.69,7.43,527,163,690
2355,영우디에스피,143540,10.39,22.49,35,659,694
957,삼원강재,023000,12.98,3.84,176,518,694
1611,코웨이,021240,13.25,31.51,197,498,695
2241,휴켐스,069260,21.15,7.51,544,153,697
1702,서린바이오,038070,22.82,8.18,592,112,704
2394,진양제약,007370,22.85,8.17,593,113,706
1144,이루온,065440,18.12,5.97,417,290,707
1257,삼성생명,032830,12.5,3.53,152,557,709
912,KPX홀딩스,092230,1.82,20.0,9,701,710
693,팜스코,036580,14.28,4.21,255,457,712
2361,오파스넷,173130,11.84,29.88,106,607,713
1840,HDC현대EP,089470,15.31,4.79,311,402,713
101,경창산업,024910,18.65,6.01,439,281,720
775,세종텔레콤,036630,16.8,5.2,369,355,724
2096,티피씨글로벌,130740,13.28,3.82,202,523,725
953,사조씨푸드,014710,13.22,3.78,195,532,727
1960,대동기어,008830,13.45,3.83,209,520,729
2002,심텍,222800,11.76,25.12,98,631,729
1285,조광피혁,004700,20.06,6.66,511,221,732
583,흥국에프엔비,189980,19.24,6.12,465,269,734
1339,TS인베스트먼트,246690,10.76,20.55,50,689,739
16,경농,002100,20.64,6.69,525,217,742
2367,위즈코프,038620,20.66,6.71,526,216,742
1190,하이로닉,149980,23.03,7.72,603,139,742
232,컴투스,078340,25.5,8.49,657,86,743
1334,SBS콘텐츠허브,046140,17.26,5.1,386,359,745
21,기아,000270,17.0,5.05,378,367,745
1629,현대모비스,012330,15.89,4.66,330,417,747
793,씨큐브,101240,20.4,6.56,521,227,748
908,DSR제강,069730,13.32,3.67,205,543,748
1071,바이넥스,053030,131.44,3.84,232,517,749
20,극동유화,014530,15.63,4.54,320,429,749
117,대유,290380,23.38,7.71,614,141,755
1142,유에스티,263770,29.95,9.89,745,11,756
1882,삼양식품,003230,11.32,21.46,85,671,756
553,테고사이언스,191420,132.71,3.83,235,522,757
2090,켐트로스,220260,124.48,3.32,181,577,758
566,피엔티,137400,14.56,33.56,265,494,759
2043,우리기술투자,041190,14.3,30.42,256,503,759
1200,휴온스,243070,12.07,25.66,134,627,761
708,한신기계공업,011700,15.28,4.24,309,454,763
1670,디케이앤디,263020,21.47,6.81,554,212,766
475,아래스,050320,160.21,4.9,374,394,768
665,쌍용씨앤이,003410,24.42,7.92,641,127,768
255,푸드웰,005670,18.15,5.23,420,352,772
1877,미원상사,002840,11.72,21.07,95,678,773
978,우리들휴브레인,118000,11.15,20.12,76,697,773
1376,마니커에프앤지,195500,26.84,8.48,686,87,773
1806,한국비엔씨,256840,150.6,4.41,335,439,774
695,하이트진로,000080,26.18,8.23,673,102,775
1657,대동금속,020400,15.82,4.32,327,448,775
1158,케이사인,192250,23.43,7.41,615,166,781
1582,삼천리,004690,10.33,2.49,32,753,785
968,써니전자,004770,30.03,9.92,778,10,788
1692,비에이치,090460,28.08,8.69,714,78,792
994,태경케미컬,006890,21.22,6.37,548,245,793
1161,켐온,217600,150.44,4.18,334,459,793
116,대봉엘에스,078140,21.14,6.31,543,252,795
1470,인피니트헬스케어,071200,25.12,7.6,650,148,798
119,대주산업,003310,22.11,6.59,574,225,799
468,슈프리마,236200,22.67,6.68,587,219,806
546,코위버,056360,17.58,4.66,391,416,807
2258,YTN,040300,16.16,4.18,347,460,807
310,교보증권,030610,3.74,9.35,770,38,808
1734,에이치엘사이언스,239610,12.34,22.19,146,662,808
1256,삼성공조,006660,10.87,2.46,54,756,810
204,유신,054930,14.67,3.69,274,539,813
629,동서,026960,28.92,8.61,729,84,813
1433,에코마케팅,230360,18.35,42.16,429,387,816
1755,위더스제약,330350,101.47,2.43,59,758,817
267,한솔인티큐브,070590,23.26,6.84,607,211,818
2270,다나와,119860,13.0,25.11,186,632,818
1866,대호에이엘,069460,102.91,2.43,60,759,819
1588,아세아시멘트,183190,11.9,2.94,109,710,819
124,디에이피,066900,18.35,4.88,428,396,824
786,시큐브,131090,26.97,7.79,689,135,824
1730,에스에이티,060540,17.39,4.49,388,437,825
1514,한독크린텍,256150,12.85,22.76,169,656,825
913,KSS해운,044450,18.28,4.78,423,404,827
76,포스코,005490,14.8,3.61,285,546,831
707,한신공영,004960,1.83,18.96,10,822,832
2223,하나금융지주,086790,3.93,8.96,775,65,840
523,제일바이오,052670,114.37,2.85,122,719,841
2285,레드로버,060300,31.5,9.16,793,50,843
2195,엘에스일렉트릭,010120,22.22,6.14,580,266,846
1350,나이스정보통신,036800,21.1,5.74,541,306,847
1722,아시아경제,127710,14.38,3.17,258,589,847
1356,노바텍,285490,19.27,44.1,467,381,848
2154,광명전기,017040,18.64,4.67,437,415,852
2300,비비씨,318410,10.06,18.04,15,838,853
651,삼일제약,000520,100.83,2.13,58,796,854
1523,흥구석유,024060,22.6,6.12,584,271,855
492,오션브릿지,241790,12.73,20.23,162,693,855
2009,아이디스,143160,26.04,7.14,668,188,856
1990,빅솔론,093190,15.86,3.8,329,527,856
372,한국주철관공업,000970,17.2,4.04,382,476,858
411,노바렉스,194700,13.95,24.25,226,639,865
1838,DB하이텍,000990,13.67,23.07,217,650,867
926,기신정기,092440,17.89,4.06,399,472,871
785,시공테크,020710,19.17,4.74,462,409,871
2048,월덱스,101160,13.32,21.96,206,665,871
1261,삼화전기,009470,32.66,9.04,812,61,873
1159,케이씨에스,115500,36.42,9.93,864,9,873
114,농우바이오,054050,17.82,4.03,396,478,874
403,고영,098460,157.37,3.74,340,535,875
1743,연우,115960,20.93,5.31,533,344,877
1496,크린앤사이언스,045520,14.5,28.02,262,615,877
38,삼성엔지니어링,028050,10.29,17.32,28,855,883
2338,에스아이리소스,065420,35.19,9.42,851,32,883
431,리더스코스메틱,016100,2.92,46.92,507,377,884
1157,컴퍼니케이,307930,10.72,17.98,47,841,888
2115,휴림로봇,090710,3.67,76.89,768,122,890
528,지니뮤직,043610,23.35,6.02,613,279,892
730,넥스트아이,137940,2.98,43.56,510,383,893
914,LG화학,051910,125.83,2.93,183,711,894
1797,파인테크닉스,106240,34.98,9.22,849,46,895
2102,하림지주,003380,15.27,3.18,308,588,896
328,롯데제과,280360,15.97,3.42,331,565,896
1029,경남스틸,039240,15.83,3.4,328,569,897
1154,제룡전기,033100,24.1,6.14,633,264,897
779,솔브레인홀딩스,036830,0.44,154.56,0,897,897
259,피제이전자,006140,19.69,4.58,476,424,900
307,SK렌터카,068400,19.28,4.5,469,433,902
1684,미래테크놀로지,213090,19.19,4.39,463,441,904
269,한컴위드,054920,23.5,5.99,619,288,907
1924,한국카본,017960,10.3,16.55,29,880,909
1605,진양폴리우레탄,010640,24.0,6.03,632,278,910
1123,엠투아이,347890,13.88,20.58,223,688,911
2171,드림텍,192650,34.41,8.79,838,76,914
2022,에스티아이,039440,26.26,6.42,678,239,917
829,웹젠,069080,14.17,21.83,251,666,917
131,링크제니시스,219420,119.07,2.15,126,793,919
851,제이앤티씨,204270,11.05,17.43,69,851,920
940,디아이동일,001530,18.73,4.0,440,481,921
1280,우성사료,006980,16.09,3.28,344,579,923
2259,골프존,215000,11.36,18.02,86,840,926
916,LS,006260,18.12,3.94,416,511,927
340,세이브존I&C,067830,12.2,2.2,140,788,928
1388,비엠티,086670,23.19,5.58,605,323,928
2143,HMM,011200,36.32,8.92,863,69,932
1978,맘스터치,220630,15.81,29.6,326,610,936
1189,하나머티리얼즈,166090,14.75,22.82,283,654,937
999,하나제약,293480,28.03,6.58,713,226,939
715,KCC건설,021320,4.92,9.68,917,23,940
2101,피앤씨테크,237750,17.57,3.58,390,552,942
1879,보령제약,003850,36.02,8.62,859,83,942
1863,대한제분,001130,13.47,2.7,210,734,944
619,녹십자홀딩스,005250,12.03,19.74,132,814,946
64,일진다이아,081000,130.57,2.88,231,715,946
1264,서흥,008490,11.13,16.73,74,874,948
2297,브이원텍,251630,28.65,6.63,725,224,949
1018,GST,083450,10.14,15.06,19,931,950
2204,율촌화학,008730,25.26,5.85,655,299,954
723,고려시멘트,198440,21.8,4.92,562,392,954
1220,DGB금융지주,139130,3.46,6.93,760,203,963
2097,파트론,091700,27.74,6.2,705,259,964
2392,지어소프트,051160,26.67,55.83,684,283,967
1965,대정화금,120240,30.22,7.15,780,187,967
2038,오리엔탈정공,014940,3.82,64.06,773,194,967
2207,인팩,023810,18.06,3.55,414,555,969
716,KCI,036670,10.62,15.09,42,929,971
2290,매커스,093520,10.17,14.57,21,950,971
1968,동성화인텍,033500,14.95,20.79,291,682,973
1625,한전산업,130660,11.37,16.2,87,888,975
1620,한라,014790,2.19,34.98,487,491,978
1432,에이피티씨,089970,19.84,31.34,478,500,978
2168,동일고무벨트,163560,18.83,3.7,444,536,980
202,유니온커뮤니티,203450,28.58,6.23,724,257,981
2332,알로이스,297570,12.82,19.11,166,820,986
1185,피에스케이홀딩스,031980,2.82,38.01,502,485,987
1414,씨이랩,189330,165.12,27.84,376,617,993
1068,민앤지,214180,11.62,15.9,93,902,995
342,신송홀딩스,006880,17.68,3.04,393,603,996
2291,메디아나,041920,12.58,17.95,156,842,998
1293,쿠쿠홈시스,284740,11.77,15.94,99,899,998
1627,한화솔루션,009830,25.19,5.3,652,348,1000
1747,와이오엠,066430,11.03,15.03,67,933,1000
1344,경동제약,011040,24.76,5.1,643,360,1003
409,넥스틴,348210,32.57,62.17,809,195,1004
1307,한국쉘석유,002960,15.99,21.44,333,672,1005
646,삼성에스디에스,018260,31.15,6.71,791,215,1006
1419,안랩,053800,41.1,8.8,932,74,1006
1751,우주일렉트로,065680,30.44,6.64,784,223,1007
884,프로텍,053610,26.36,5.54,680,328,1008
1178,포스코 ICT,022100,135.84,2.36,239,769,1008
643,범양건영,002410,10.99,14.51,57,952,1009
872,태웅로직스,124560,11.79,15.65,102,908,1010
1030,광진윈텍,090150,21.31,4.13,549,464,1013
49,신한지주,055550,4.75,8.2,913,106,1019
2320,신일제약,012790,34.5,7.23,841,178,1019
2227,한성기업,003680,22.75,4.52,589,431,1020
1231,SK케미칼,285130,20.37,30.48,518,502,1020
1720,씨젠,096530,10.09,125.91,16,1006,1022
407,남화토건,091590,23.75,4.79,622,401,1023
1059,마이크로프랜드,147760,11.11,14.48,73,953,1026
1746,와이엔텍,067900,11.43,15.0,90,936,1026
491,오성첨단소재,052420,27.16,5.55,700,326,1026
743,동국알앤에스,075970,20.22,3.93,516,512,1028
657,센트랄모텍,308170,33.08,6.84,818,210,1028
2239,현대코퍼레이션홀딩스,227840,5.78,9.98,1025,3,1028
843,인산가,277410,11.1,14.38,72,958,1030
140,삼보판지,023600,5.36,9.64,1005,26,1031
1063,메이슨캐피탈,021880,31.07,6.39,790,242,1032
1409,신성델타테크,065350,30.78,6.37,787,246,1033
1498,클리오,237880,31.73,6.42,796,238,1034
1310,한솔제지,213500,5.56,9.67,1011,24,1035
2146,JW홀딩스,096760,37.38,7.45,873,162,1035
600,BNK금융지주,138930,3.56,6.11,764,272,1036
1677,마크로젠,038290,3.26,56.72,757,282,1039
1969,동양에스텍,060380,5.81,9.87,1027,13,1040
2414,티플랙스,081150,20.21,3.81,515,526,1041
217,인텍플러스,064290,21.41,35.22,551,490,1041
1890,아남전자,008700,49.44,9.11,987,56,1043
983,유진증권,001200,5.07,9.11,992,55,1047
500,원익큐브,014190,20.11,3.74,513,534,1047
2226,한국특강,007280,22.17,4.06,576,473,1049
1311,한솔케미칼,014680,18.09,24.5,415,638,1053
2313,셀트리온헬스케어,091990,104.73,13.36,61,992,1053
1445,오이솔루션,138080,48.08,8.63,975,82,1057
408,네오팜,092730,12.92,16.23,172,887,1059
797,아이디피,332370,28.44,5.35,720,340,1060
1845,SIMPAC,009160,4.73,7.54,910,151,1061
976,영원무역홀딩스,009970,4.91,7.64,916,145,1061
2432,한라IMS,092460,22.79,4.06,591,470,1061
947,무학,033920,15.44,2.55,317,746,1063
623,대웅제약,069620,149.9,2.38,298,765,1063
1714,신라섬유,001000,146.58,2.38,297,767,1064
1303,퍼스텍,010820,14.24,19.81,252,812,1064
250,파세코,037070,13.63,17.46,216,850,1066
2253,SGA,049470,10.31,12.43,31,1035,1066
42,삼호개발,010960,5.75,9.26,1023,44,1067
702,한국항공우주,047810,33.7,6.39,827,240,1067
392,HRS,036640,10.05,11.93,14,1054,1068
2140,DB손해보험,005830,5.54,9.08,1010,58,1068
2052,유니셈,036200,12.49,15.25,151,919,1070
1035,네오셈,253590,16.8,20.01,370,700,1070
1193,한국컴퓨터,054040,5.33,8.93,1003,68,1071
1165,콜마비앤에이치,200130,19.05,27.88,455,616,1071
540,코리아센터,290510,39.4,7.17,886,185,1071
77,포스코강판,058430,16.47,2.88,357,716,1073
799,아프리카TV,067160,19.0,27.56,453,621,1074
2366,원익피앤이,131390,17.0,20.17,379,696,1075
2084,케어랩스,263700,29.53,5.4,740,337,1077
735,다원시스,068240,37.06,6.86,869,209,1078
1758,윈스,136540,12.54,15.2,153,925,1078
1652,나이스디앤비,130580,14.02,18.38,245,833,1078
452,삼일기업공사,002290,23.27,4.06,608,471,1079
1064,모바일리더,100030,12.23,14.99,142,937,1079
173,앤디포스,238090,36.51,6.72,867,213,1080
103,국순당,043650,5.37,8.79,1006,75,1081
1147,이엘피,063760,20.74,3.59,530,551,1081
1079,서연탑메탈,019770,29.44,5.33,739,342,1081
300,KB금융,105560,5.22,8.53,998,85,1083
751,램테크놀러지,171010,36.49,6.68,866,218,1084
68,조비,001550,32.66,6.06,811,274,1085
153,스페코,013810,18.51,22.93,434,653,1087
1664,드림시큐리티,203650,40.31,7.42,924,164,1088
1399,세원,234100,14.53,18.7,264,827,1091
1181,풍국주정,023900,32.19,5.98,802,289,1091
1361,대원미디어,048910,28.55,5.03,723,369,1092
1094,씨앤지하이테크,264660,11.98,13.91,118,974,1092
1878,방림,003610,16.33,2.62,352,741,1093
1077,사람인에이치알,143240,14.5,18.4,261,832,1093
1284,제일연마,001560,22.12,3.84,575,519,1094
1513,한글과컴퓨터,030520,12.44,14.72,149,946,1095
2337,에스씨디,042110,21.63,3.68,557,541,1098
1798,팜스빌,318010,29.89,5.21,744,354,1098
1590,에스제이엠홀딩스,025530,15.19,2.02,303,802,1105
2177,미원홀딩스,107590,10.23,11.35,25,1083,1108
2027,에코프로,086520,48.91,7.87,980,128,1108
72,코오롱인더,120110,6.0,9.7,1088,20,1108
316,넷마블,251270,36.05,6.35,860,248,1108
200,웰크론,065950,13.96,16.54,228,881,1109
1887,신대양제지,016590,6.06,9.72,1092,17,1109
1349,나스미디어,089600,12.84,14.85,167,943,1110
2374,이루다,164060,18.33,20.74,427,683,1110
1997,서희건설,035890,2.56,27.81,493,618,1111
1495,크리스탈신소재,900250,5.18,8.09,996,115,1111
934,대창,012800,21.42,3.5,552,560,1112
425,디오,039840,44.05,7.37,947,167,1114
1152,제노레이,122310,13.95,16.13,227,890,1117
1993,상신전자,263810,33.55,5.87,823,295,1118
149,셀트리온제약,068760,416.13,7.21,939,179,1118
1790,테크윙,089030,14.25,16.97,254,864,1118
2244,AP시스템,265520,15.22,19.78,305,813,1118
1941,KG이니시스,035600,13.25,15.23,198,921,1119
375,한국토지신탁,034830,6.01,9.44,1089,31,1120
1621,한미반도체,042700,18.76,21.03,441,679,1120
57,우진,105840,2.6,25.83,495,626,1121
2336,얼라인드,238120,152.01,2.21,338,784,1122
1931,현대글로비스,086280,11.38,12.45,89,1034,1123
1295,크라운해태홀딩스,005740,5.93,8.4,1031,92,1123
1139,원익홀딩스,030530,6.23,9.68,1104,22,1126
1323,CNH,023460,2.72,25.3,498,629,1127
948,미래아이앤지,007120,2.59,24.75,494,635,1129
314,기업은행,024110,4.41,6.44,898,236,1134
89,현대차증권,001500,5.79,8.2,1026,109,1135
1508,푸른저축은행,007330,5.7,8.07,1021,116,1137
2342,에스폴리텍,050760,12.16,13.09,138,1002,1140
362,코오롱,002020,2.0,22.75,483,657,1140
516,인선이엔티,060150,12.66,13.72,160,980,1140
1333,LX세미콘,108320,13.05,14.44,187,956,1143
2287,로체시스템즈,071280,11.77,12.08,100,1044,1144
9,LG전자,066570,12.4,13.23,147,997,1144
2059,이라이콤,041520,24.28,3.97,637,507,1144
91,3S,060310,154.57,2.0,339,806,1145
382,화승인더스트리,006060,10.56,10.94,40,1106,1146
890,한국정보통신,025770,31.77,5.24,797,350,1147
63,일성건설,013360,21.5,3.16,556,592,1148
1021,KMH,122450,12.64,13.44,159,990,1149
304,LS전선아시아,229640,32.53,5.35,808,341,1149
2170,두올,016740,21.18,3.0,545,606,1151
1109,에스엔유,080000,27.14,4.21,699,456,1155
2247,GRT,900290,1.86,10.32,11,1144,1155
2383,인화정공,101930,2.05,21.41,485,673,1158
1422,에스넷,038680,30.94,5.0,788,371,1159
1184,피씨디렉트,051380,14.25,15.7,253,906,1159
1497,클래시스,214150,26.11,36.06,672,488,1160
1569,동아에스티,170900,27.6,4.21,703,458,1161
704,한미사이언스,008930,226.62,3.46,599,562,1161
212,이스트소프트,047560,14.47,15.7,260,905,1165
2185,성신양회,004980,18.14,2.53,418,748,1166
1472,잉글우드랩,950140,32.17,5.06,801,366,1167
633,디아이,003160,27.59,4.13,702,465,1167
1883,삼영전자공업,005680,17.86,2.34,398,770,1168
688,코스모신소재,005070,48.97,7.16,982,186,1168
2378,이지홀딩스,035810,2.51,21.17,492,676,1168
1891,아세아제지,002310,6.15,8.9,1101,70,1171
243,키네마스터,139670,151.54,18.34,337,834,1171
327,디티알오토모티브,007340,5.6,7.48,1014,158,1172
1146,이엔에프테크놀로지,102710,14.68,16.06,276,896,1172
2307,상상인인더스트리,101000,34.59,5.51,843,330,1173
1696,비츠로테크,042370,11.24,11.11,82,1091,1173
2091,코리아에프티,123410,22.01,3.05,572,601,1173
1244,두산퓨얼셀,336260,277.51,4.18,712,461,1173
620,농심홀딩스,072710,5.25,7.23,1000,176,1176
1689,뷰웍스,100120,13.26,13.8,199,979,1178
2180,삼성물산,028260,25.24,3.81,653,525,1178
189,엘아이에스,138690,37.3,5.74,871,307,1178
1635,후성,093370,182.36,2.79,452,727,1179
1545,F&F 홀딩스,007700,15.15,16.59,302,879,1181
690,테이팩스,055490,12.86,12.86,170,1014,1184
647,삼성증권,016360,7.11,9.89,1173,12,1185
822,영림원소프트랩,060850,20.63,22.2,524,661,1185
1885,새론오토모티브,075180,19.28,2.86,468,718,1186
1248,미창석유공업,003650,5.68,7.36,1018,168,1186
1338,TPC,048770,13.44,13.85,208,978,1186
626,덕성,004830,37.0,5.61,868,319,1187
871,키이스트,054780,20.74,22.42,529,660,1189
1016,DSC인베스트먼트,241520,4.5,51.02,903,286,1189
2008,아바텍,149950,25.63,3.8,661,528,1189
1925,한농화성,011500,10.72,10.34,49,1141,1190
1603,제일기획,030000,15.06,16.11,299,891,1190
2111,한일진공,123840,6.8,9.07,1131,59,1190
833,유비쿼스,264450,15.78,16.92,325,868,1193
2215,진양홀딩스,100250,6.04,8.23,1090,103,1193
62,인터지스,129260,19.33,2.81,470,724,1194
1510,피제이메탈,128660,11.94,11.42,114,1082,1196
1853,경보제약,214390,41.56,6.16,936,262,1198
1613,태경비케이,014580,24.15,3.42,634,567,1201
335,삼진제약,005500,13.59,13.57,213,988,1201
2435,홈센타홀딩스,060560,28.68,4.04,726,477,1203
1659,대신정보통신,020180,44.58,6.33,952,251,1203
2214,진양산업,003780,12.81,12.16,165,1040,1205
136,미스터블루,207760,22.18,25.45,577,628,1205
1847,SK디앤디,210980,14.52,14.88,263,942,1205
2063,이크레더블,092130,21.69,23.4,560,646,1206
1315,해성디에스,195870,13.83,13.62,222,984,1206
2327,아바코,083930,11.56,10.73,91,1123,1214
1800,포메탈,119500,27.21,3.91,701,513,1214
190,엠게임,058630,15.31,15.71,310,904,1214
711,효성 ITX,094280,22.62,25.21,585,630,1215
1026,가비아,079940,14.7,14.99,278,938,1216
542,코메론,049430,6.66,8.37,1123,96,1219
1609,코스맥스,192820,46.85,6.23,965,256,1221
640,모토닉,009680,26.21,3.61,675,548,1223
962,세원정공,021820,10.65,1.85,43,1180,1223
185,엑시콘,092870,14.33,14.07,257,971,1228
982,유안타증권,003470,6.18,7.92,1102,126,1228
930,대동전자,008110,18.84,2.22,445,783,1228
2419,프럼파스트,035200,30.02,4.26,777,452,1229
1907,일진머티리얼즈,020150,54.92,7.23,1056,177,1233
2044,우리바이오,082850,16.4,16.47,354,882,1236
988,조광페인트,004910,19.44,2.38,472,764,1236
928,녹십자,006280,58.54,7.48,1078,159,1237
2076,중앙에너비스,000440,3.0,35.98,750,489,1239
264,한국맥널티,222980,14.62,14.09,271,968,1239
2400,코나아이,052400,21.87,21.31,564,675,1239
885,피에이치씨,057880,16.03,15.98,342,898,1240
1049,동진쎄미켐,005290,22.01,21.58,571,669,1240
1351,남화산업,111710,34.57,4.8,842,399,1241
1888,신세계I&C,035510,3.1,33.89,752,492,1244
47,세아제강지주,003030,10.8,1.76,53,1192,1245
96,KB오토시스,024120,25.72,3.24,665,582,1247
2339,에스에프에이,056190,12.8,11.33,164,1085,1249
1807,한국파마,032300,68.7,8.64,1168,81,1249
1288,케이씨텍,281820,14.42,13.39,259,991,1250
450,삼양옵틱스,225190,44.38,5.8,949,303,1252
1606,케이씨,029460,7.82,9.19,1204,48,1252
3,HDC현대산업개발,294870,7.26,8.85,1180,72,1252
1967,덕우전자,263600,12.48,10.98,150,1102,1252
1273,신풍제지,002870,3.71,38.76,769,484,1253
196,오스템임플란트,048260,6.81,78.8,1132,121,1253
970,아세아,002030,4.72,5.3,909,345,1254
1658,대림제지,017650,6.5,7.73,1116,138,1254
268,한양디지텍,078350,13.12,11.71,190,1064,1254
214,이엠넷,123570,13.1,11.68,188,1066,1254
864,케이엠더블유,032500,120.64,11.54,178,1076,1254
515,인바디,041830,13.55,12.09,212,1043,1255
509,이글벳,044960,52.19,6.71,1042,214,1256
1598,일진홀딩스,015860,27.13,3.51,697,559,1256
414,대아티아이,045390,58.18,7.19,1076,181,1257
1980,메가스터디,072870,6.5,7.71,1118,140,1258
1708,세진티에스,067770,12.1,10.75,136,1122,1258
1162,코세스,089890,23.24,22.76,606,655,1261
2217,진흥기업,002780,18.65,18.86,438,824,1262
477,아미코젠,092040,23.34,22.99,612,651,1263
1457,유니테크노,241690,14.91,13.87,288,976,1264
1557,광주신세계,037710,5.67,6.35,1017,247,1264
1556,광동제약,009290,11.84,10.08,105,1160,1265
1777,케이디켐,221980,7.6,8.82,1197,73,1270
1729,에스맥,097780,14.06,12.75,247,1023,1270
1791,티씨케이,064760,24.17,24.65,635,636,1271
2106,한국가구,004590,7.25,8.39,1179,93,1272
1511,한국전자인증,041460,51.89,6.51,1041,231,1272
792,씨엠에스에듀,225330,16.43,15.25,356,918,1274
1947,SBI인베스트먼트,019550,14.97,13.67,292,983,1275
398,SCI평가정보,036120,25.36,26.34,656,624,1280
753,레몬,294140,30.23,31.49,781,499,1280
1760,유라테크,048430,32.2,4.03,803,480,1283
39,삼성출판사,068290,4.5,45.58,904,379,1283
2184,선도전기,007610,21.66,2.8,559,725,1284
1935,현대해상,001450,6.13,7.12,1097,189,1286
2283,디지캡,197140,29.25,3.6,737,550,1287
2376,이엔드디,101360,81.74,9.95,1279,8,1287
599,BGF리테일,282330,19.09,18.6,458,830,1288
198,옵티시스,109080,30.06,3.96,779,509,1288
478,아이에이,038880,18.61,17.35,436,854,1290
927,남선알미늄,008350,49.22,5.72,983,308,1291
1410,신화인터텍,056700,28.7,3.42,727,566,1293
1490,케이에스피,073010,44.48,5.33,951,343,1294
1867,동남합성,023450,17.91,16.1,402,893,1295
1656,누리플렉스,040160,34.2,4.15,834,463,1297
789,신흥에스이씨,243840,17.76,15.83,394,903,1297
297,CJ대한통운,000120,30.69,3.89,785,514,1299
1287,카카오,035720,219.25,2.7,569,732,1301
877,티비씨,033830,28.93,3.36,730,571,1301
1812,현대공업,170030,12.68,10.33,161,1142,1303
368,포스코케미칼,003670,225.74,2.96,597,707,1304
1279,우리금융지주,316140,5.38,5.87,1007,297,1304
1163,코엔텍,029960,18.46,16.79,432,872,1304
118,대유에이피,290120,14.1,11.93,250,1055,1305
1577,미원에스씨,268280,15.54,13.58,318,987,1305
365,큐로,015590,107.18,1.33,65,1242,1307
668,아이에스동서,010780,13.28,10.92,201,1107,1308
1895,엔케이물산,009810,6.52,7.04,1119,190,1309
1983,모바일어플라이언스,087260,60.53,7.31,1138,171,1309
83,한창제지,009460,14.03,11.72,246,1063,1309
1982,모다이노칩,080420,27.95,3.07,709,600,1309
1913,케이티스카이라이프,053210,7.36,7.97,1187,124,1311
1302,팬오션,028670,29.0,3.25,733,581,1314
812,에이텍티앤,224110,47.42,5.3,969,347,1316
1580,삼양홀딩스,000070,6.46,6.96,1115,201,1316
1801,플레이위드,023770,5.93,52.24,1032,285,1317
401,갤럭시아머니트리,094480,36.46,4.24,865,453,1318
1753,웹케시,053580,27.87,28.66,707,613,1320
577,한컴MDS,086960,30.39,3.69,783,538,1321
1234,계룡건설산업,013580,2.66,18.69,496,828,1324
1058,링네트,042500,14.63,11.95,273,1052,1325
580,휴네시온,290270,15.97,13.3,332,994,1326
1471,일신바이오,068330,87.97,9.39,1294,34,1328
22,까뮤이앤씨,013700,14.69,11.97,277,1051,1328
1520,휴메딕스,200670,15.7,12.99,321,1007,1328
163,아이센스,099190,15.36,12.84,313,1016,1329
632,동양생명,082640,4.42,4.52,899,432,1331
791,쎄트렉아이,099320,19.62,17.32,475,856,1331
1443,엠케이전자,033160,8.31,8.42,1243,88,1331
1241,대성홀딩스,016710,9.34,9.73,1317,16,1333
673,엠씨넥스,097520,18.77,16.1,442,892,1334
929,대덕,008060,2.33,17.88,490,845,1335
169,아이티센,124500,16.78,14.09,367,969,1336
1599,자이에스앤디,317400,16.29,13.59,351,985,1336
1616,포스코인터내셔널,047050,7.52,7.69,1194,142,1336
464,셀바스AI,108860,15.08,12.3,300,1037,1337
1278,오리온,271560,18.32,15.5,426,913,1339
15,갤럭시아에스엠,011420,40.04,4.63,922,419,1341
224,제이엠티,094970,9.15,9.39,1308,35,1343
1502,파마리서치,214450,17.4,14.42,389,957,1346
2160,대동,000490,7.92,7.74,1210,137,1347
499,원방테크,053080,14.61,11.52,269,1078,1347
1375,린드먼아시아,277070,13.96,10.79,229,1119,1348
1544,E1,017940,5.08,5.18,993,356,1349
1023,SK머티리얼즈,036490,29.14,28.49,736,614,1350
1766,인지디스플레,037330,9.28,9.36,1315,37,1352
2368,윈팩,097800,13.6,10.4,214,1138,1352
2268,누리플랜,069140,13.14,10.07,191,1161,1352
2399,케이엘넷,039420,14.84,11.67,286,1068,1354
2006,아모그린텍,125210,236.11,2.81,631,723,1354
827,원익머트리얼즈,104830,13.34,10.26,207,1148,1355
1084,선데이토즈,123420,13.92,10.42,224,1135,1359
1952,금강철강,053260,23.3,2.53,610,749,1359
1775,진로발효,018120,17.89,14.36,400,959,1359
1553,경동도시가스,267290,5.77,5.46,1024,335,1359
1201,휴젤,145020,55.84,5.81,1060,300,1360
2152,경동나비엔,009450,16.12,12.83,345,1017,1362
1709,세화피앤씨,252500,18.92,15.26,447,917,1364
761,바이오니아,064550,7.1,65.71,1172,193,1365
2364,우리산업,215360,41.45,4.53,935,430,1365
2301,비씨월드제약,200780,44.93,4.69,954,413,1367
1615,팜젠사이언스,004720,16.79,13.21,368,999,1367
1110,에스텍파마,041910,13.74,10.23,218,1150,1368
1562,대신증권,003540,7.61,7.35,1199,170,1369
1195,한일사료,005860,32.32,3.46,806,563,1369
2164,대창단조,015230,7.46,7.2,1189,180,1369
820,엘디티,096870,16.17,12.78,348,1021,1369
1955,나라엠앤디,051490,126.52,1.81,184,1187,1371
832,유비벨록스,089850,9.52,9.15,1323,52,1375
987,인스코비,006490,81.59,8.32,1278,98,1376
2169,동일산업,004890,22.97,2.24,596,780,1376
1014,황금에스티,032560,6.75,6.34,1129,249,1378
737,대성미생물,036480,40.54,4.28,927,451,1378
2176,미래에셋증권,006800,9.25,8.94,1313,67,1380
778,솔본,035610,114.31,1.04,121,1261,1382
879,파나진,046210,28.14,21.72,716,668,1384
1742,엠에스씨,009780,9.86,9.31,1344,41,1385
1900,원림,005820,2.83,16.31,503,884,1387
2281,동화기업,025900,42.68,4.33,941,446,1387
228,지엔씨에너지,119850,34.24,3.55,835,554,1389
2086,케이엠,083550,4.26,32.92,894,496,1390
1622,한섬,020000,8.76,7.85,1261,130,1391
1761,율호,072770,47.15,4.58,968,423,1391
838,이녹스첨단소재,272290,17.67,13.17,392,1000,1392
1395,서울바이오시스,092190,66.88,6.51,1161,232,1393
538,코데즈컴바인,047770,17.21,12.91,384,1009,1393
1875,메리츠금융지주,138040,2.74,16.06,499,895,1394
44,선진,136490,3.21,24.25,755,640,1395
1986,바이오톡스텍,086040,84.9,8.2,1287,108,1395
1247,문배철강,008420,8.14,7.47,1235,160,1395
1782,코맥스,036690,34.42,3.51,839,558,1397
2407,큐에스아이,066310,1067.03,0.25,64,1334,1398
1227,LX인터내셔널,001120,3.22,23.71,756,643,1399
1698,빅텍,065450,65.11,6.39,1156,243,1399
1252,부산도시가스,015350,3.13,23.35,753,647,1400
1663,동운아나텍,094170,266.32,2.91,692,712,1404
2357,예선테크,250930,49.74,4.64,989,418,1407
1454,위세아이텍,065370,22.43,18.82,583,826,1409
867,코미코,183300,20.26,16.06,517,894,1411
220,정상제이엘에스,040420,14.72,10.48,281,1130,1411
706,한솔홀딩스,004150,2.27,15.2,488,924,1412
887,필옵틱스,161580,64.61,6.22,1154,258,1412
446,부스타,008470,8.26,7.24,1239,175,1414
974,엔피씨,004250,7.3,6.53,1184,230,1414
1962,대모,317850,114.6,0.77,123,1292,1415
738,대원산업,005710,6.13,5.61,1098,318,1416
1251,부국철강,026940,110.32,0.71,119,1297,1416
907,DL건설,001880,3.94,23.71,776,642,1418
415,대양제지,006580,25.68,2.46,664,755,1419
1543,DB,012030,25.54,2.39,658,761,1419
568,핌스,347770,20.09,15.65,512,907,1419
222,제이씨현시스템,033320,16.07,11.52,343,1077,1420
87,현대비앤지스틸,004560,6.35,5.68,1108,312,1420
2427,한국기업평가,034950,23.32,19.89,611,809,1420
1623,한세실업,105630,15.59,10.97,319,1103,1422
359,코리아써키트,007810,35.25,3.39,852,570,1422
2252,SFA반도체,036540,56.81,5.22,1071,353,1424
463,세명전기,017510,28.51,2.99,722,703,1425
1950,고려제약,014570,15.39,10.83,314,1116,1430
950,부산산업,011390,49.29,4.33,984,447,1431
966,신성통상,005390,34.35,3.12,837,595,1432
1291,코리안리,003690,6.69,5.78,1128,305,1433
1156,칩스앤미디어,094360,60.99,5.96,1142,291,1433
344,신풍제약,019170,1367.82,1.72,241,1195,1436
1036,네오위즈홀딩스,042420,2.81,15.01,501,935,1436
1448,와이엠티,251370,21.01,15.94,537,900,1437
1243,동원산업,006040,3.4,21.01,758,680,1438
1750,우리조명,037400,9.05,7.75,1302,136,1438
975,영원무역,111770,9.51,8.03,1320,118,1438
660,수산중공업,017550,40.84,3.95,930,510,1440
2055,유진기업,023410,7.37,6.31,1188,253,1441
511,이랜시스,264850,18.28,12.79,422,1020,1442
254,포인트엔지니어링,256630,17.96,12.18,404,1039,1443
732,노터스,278650,22.86,17.38,594,852,1446
1881,삼아알미늄,006110,36.18,3.2,862,585,1447
2025,에이치케이,044780,27.1,2.49,696,752,1448
1552,STX엔진,077970,9.75,8.19,1339,110,1449
1705,선광,003100,26.21,2.24,674,777,1451
1736,에이테크솔루션,071670,43.09,3.96,944,508,1452
517,인포바인,115310,9.12,7.6,1307,147,1454
1187,피엔케이피부임상연구센타,347740,22.28,16.77,582,873,1455
17,경동인베스트,012320,4.84,3.68,914,542,1456
343,신일전자,002700,16.62,11.08,362,1094,1456
197,오픈베이스,049480,41.15,3.82,933,524,1457
1917,풀무원,017810,42.84,3.84,943,516,1459
203,유비쿼스홀딩스,078070,53.04,4.68,1045,414,1459
1005,한양증권,001750,2.66,14.22,497,962,1459
650,삼영무역,002810,9.18,7.59,1311,149,1460
2049,웰크론한텍,076080,123.06,0.92,180,1280,1460
2060,이베스트투자증권,078020,3.54,20.09,763,698,1461
201,위지트,036090,15.39,10.29,315,1147,1462
67,제일파마홀딩스,002620,29.62,2.85,742,720,1462
1984,미투온,201490,18.5,12.62,433,1030,1463
130,룽투코리아,060240,41.26,3.8,934,529,1463
1998,선익시스템,171090,28.28,2.56,719,745,1464
244,테스나,131970,25.0,19.23,648,817,1465
2423,하림,136480,36.15,3.01,861,605,1466
1667,디아이티,110990,122.9,0.86,179,1287,1466
2409,테스,095610,19.53,13.3,474,993,1467
2333,알리코제약,260660,17.03,11.25,380,1088,1468
2145,JW생명과학,234080,19.48,13.25,473,996,1469
418,덕산네오룩스,213420,25.09,18.91,649,823,1472
435,머큐리,100590,16.51,10.86,359,1113,1472
419,동국S&C,100130,131.52,1.34,233,1241,1474
1717,신화콘텍,187270,27.84,2.34,706,771,1477
1453,원익IPS,240810,22.2,15.91,578,901,1479
601,GS건설,006360,9.72,7.68,1337,143,1480
1901,유니퀘스트,077500,16.75,10.8,365,1118,1483
1638,COWON,056000,136.67,1.3,240,1244,1484
1724,아이쓰리시스템,214430,50.97,4.31,1036,449,1485
652,삼정펄프,009770,2.78,13.58,500,986,1486
1289,케이씨티시,009070,8.69,6.54,1259,228,1487
303,KTcs,058850,8.84,6.64,1266,222,1488
470,시스웍,269620,58.37,4.69,1077,412,1489
924,경인전자,009140,29.14,2.49,735,754,1489
1930,한화투자증권,003530,7.17,5.58,1175,322,1497
2113,현대이지웰,090850,26.39,19.36,681,816,1497
1587,시디즈,134790,6.4,42.92,1111,386,1497
1219,DB금융투자,016610,2.05,12.86,486,1013,1499
1936,현대홈쇼핑,057050,8.68,6.39,1258,241,1499
814,엑셈,205100,18.37,11.64,430,1070,1500
1740,엘비세미콘,061970,23.87,16.71,626,875,1501
2377,이오테크닉스,039030,67.51,5.38,1163,339,1502
1871,동원시스템즈,014820,17.95,10.97,403,1104,1507
2260,골프존뉴딘홀딩스,121440,8.42,6.17,1248,260,1508
1353,네오크레마,311390,45.07,3.58,955,553,1508
1224,KTB투자증권,030210,2.89,13.04,505,1004,1509
2089,켐트로닉스,089010,23.75,16.24,623,886,1509
29,디피씨,026890,18.97,11.76,450,1060,1510
852,제이티,089790,25.67,17.73,663,847,1510
1299,태림포장,011280,138.37,0.97,243,1268,1511
656,세아제강,306200,7.76,5.67,1201,313,1514
1573,동일제강,002690,120.5,0.23,177,1337,1514
1685,미투젠,950190,8.11,50.84,1231,287,1518
1222,HDC,012630,6.37,4.72,1109,410,1519
174,어보브반도체,102120,22.01,14.65,573,948,1521
1918,풍산홀딩스,005810,16.28,1.92,349,1173,1522
1297,키움증권,039490,4.57,27.63,905,620,1525
144,서암기계공업,100660,135.61,0.84,238,1288,1526
1179,폴라리스우노,114630,30.33,2.6,782,744,1526
2087,케이엠제약,225430,141.0,1.45,294,1232,1526
347,엔씨소프트,036570,34.8,20.83,845,681,1526
1607,케이씨씨,002380,2.94,12.79,508,1019,1527
1160,케이아이엔엑스,093320,23.49,15.63,618,909,1527
2375,이씨에스,067010,17.9,10.53,401,1128,1529
1269,신세계건설,034300,8.78,6.12,1263,268,1531
139,브랜드엑스코퍼레이션,337930,27.04,18.14,695,837,1532
205,유안타제5호스팩,336060,138.37,0.77,242,1291,1533
405,나노엔텍,039860,84.09,6.33,1284,250,1534
1676,마이크로컨텍솔,098120,45.82,3.32,957,578,1535
1551,SNT홀딩스,036530,6.5,4.62,1117,420,1537
1706,성호전자,043260,4.32,23.89,896,641,1537
2151,강남제비스코,000860,6.14,4.34,1099,445,1544
1996,서한,011370,8.33,5.86,1246,298,1544
458,상신이디피,091580,20.77,12.85,531,1015,1546
383,화천기공,000850,15.78,1.52,324,1222,1546
1841,HSD엔진,082740,45.76,3.16,956,591,1547
2108,한국팩키지,037230,71.87,5.51,1216,331,1547
1441,엠아이텍,179290,21.1,12.89,540,1010,1550
1563,대원전선,006340,33.6,2.79,825,726,1551
2412,톱텍,108230,44.17,3.03,948,604,1552
526,조이시티,067000,39.53,21.79,887,667,1554
1991,삼강엠앤티,100090,79.56,5.54,1229,327,1556
1778,케이씨티,089150,158.87,1.56,341,1216,1557
2267,녹십자웰빙,234690,162.52,1.84,375,1183,1558
253,패션플랫폼,225590,33.16,2.63,819,739,1558
2329,아이스크림에듀,289010,143.54,1.01,295,1266,1561
2213,종근당,185750,28.24,17.88,718,844,1562
856,진성티이씨,036890,18.4,10.47,431,1133,1564
701,한국콜마홀딩스,024720,4.49,21.96,901,664,1565
71,지역난방공사,071320,16.72,1.68,364,1201,1565
1636,휠라홀딩스,081660,19.11,10.94,460,1105,1565
2369,유비케어,032620,80.38,5.96,1274,292,1566
1541,BGF,027410,17.2,1.81,383,1186,1569
1131,와이솔,122990,146.35,0.95,296,1274,1570
2359,오상자이엘,053980,7.51,46.13,1193,378,1571
245,토탈소프트,045340,29.12,18.03,734,839,1573
1198,효성오앤비,097870,34.07,2.61,831,742,1573
1048,동국제약,086450,23.66,14.45,621,954,1575
719,SBI핀테크솔루션즈,950110,28.14,17.22,715,860,1575
2230,한일홀딩스,003300,6.6,4.21,1121,455,1576
8,LG이노텍,011070,18.29,10.2,424,1153,1577
630,동성케미컬,102260,32.95,2.39,815,763,1578
306,PI첨단소재,178920,26.04,15.62,669,910,1579
2385,정산애강,022220,37.85,2.98,875,705,1580
861,케어젠,214370,24.47,14.91,642,940,1582
578,현진소재,053660,inf,95.14,1582,0,1582
1321,휴비스,079980,3.46,19.01,761,821,1582
2192,에이프로젠제약,003060,38.01,2.99,881,702,1583
455,삼표시멘트,038500,31.21,2.15,792,792,1584
1367,디앤씨미디어,263720,41.57,23.23,937,648,1585
1794,티에스이,131290,25.56,15.1,659,927,1586
2157,깨끗한나라,004540,4.25,20.21,893,694,1587
377,한온시스템,018880,78.59,5.09,1224,363,1587
1246,모나미,005360,1334.49,0.09,237,1351,1588
1548,SGC에너지,005090,9.68,6.24,1335,255,1590
1859,다우기술,023590,3.57,18.85,765,825,1590
113,녹십자셀,031390,315.4,2.14,799,794,1593
1114,에이팩트,200470,19.06,10.41,456,1137,1593
1922,한국앤컴퍼니,000240,8.04,5.08,1230,364,1594
2347,에이치엘비파워,043220,173.59,1.8,407,1188,1595
1101,아이크래프트,052460,53.08,3.61,1046,549,1595
1482,중앙백신,072020,54.15,3.64,1053,545,1598
1337,SV인베스트먼트,289080,26.92,15.54,688,912,1600
371,한국종합기술,023350,8.33,5.12,1244,358,1602
1808,한창산업,079170,33.48,2.23,822,782,1604
2163,대우조선해양,042660,33.94,2.27,830,775,1605
1325,DMS,068790,4.97,20.64,921,685,1606
356,인천도시가스,034590,9.61,6.05,1330,276,1606
469,스튜디오드래곤,253450,88.69,5.71,1296,310,1606
698,한국자산신탁,123890,3.76,18.18,771,836,1607
249,파라텍,033540,26.22,15.01,676,934,1610
1329,KBI메탈,024840,32.41,2.02,807,803,1610
457,상보,027580,19.11,10.21,459,1152,1611
771,삼현철강,017480,8.44,5.09,1251,361,1612
2279,동원개발,013120,3.18,17.28,754,858,1612
395,NICE평가정보,030190,31.92,19.54,798,815,1613
1135,우양,103840,20.87,11.43,532,1081,1613
2275,더네이쳐홀딩스,298540,6.53,33.66,1120,493,1613
1488,카페24,042000,89.79,5.6,1299,320,1619
572,한국바이오젠,318000,21.19,11.6,547,1073,1620
536,케이씨피드,025880,34.08,2.17,832,791,1623
421,동아엘텍,088130,9.18,5.66,1310,316,1626
2193,에이플러스에셋,244920,5.68,29.7,1019,609,1628
2331,아이티엠반도체,084850,88.77,5.5,1297,332,1629
1335,SG&G,040610,2.01,10.3,484,1145,1629
648,삼성카드,029780,9.44,5.69,1319,311,1630
1861,대성산업,128820,2.91,10.57,506,1125,1631
1700,상상인이안1호스팩,307870,150.85,0.71,336,1296,1632
1436,에프앤가이드,064850,21.19,11.25,546,1087,1633
669,애경산업,018250,56.46,3.41,1067,568,1635
1127,오가닉티코스메틱,900300,4.5,2.69,902,735,1637
199,원익QnC,074600,21.64,11.44,558,1080,1638
2081,진매트릭스,109820,62.91,33.02,1149,495,1644
2053,유니트론텍,142210,55.23,3.2,1058,586,1644
1575,메리츠화재,000060,3.88,16.91,774,870,1644
2350,에프에스티,036810,28.86,15.31,728,916,1644
1942,KNN,058400,53.66,3.1,1047,598,1645
1362,대한과학,131220,90.27,5.95,1352,293,1645
37,삼성SDI,006400,76.91,4.54,1220,428,1648
413,대성파인텍,104040,42.74,2.96,942,708,1650
26,덴티움,145720,20.18,10.34,514,1140,1654
2211,제주은행,006220,6.07,3.48,1093,561,1654
1054,레이크머티리얼즈,281740,91.16,5.81,1353,302,1655
989,조선내화,000480,9.61,5.55,1332,325,1657
703,한라홀딩스,060980,8.89,4.97,1269,389,1658
1223,KISCO홀딩스,001940,7.6,4.16,1198,462,1660
25,대웅,003090,29.73,15.1,743,926,1669
350,영풍,000670,7.47,4.03,1190,479,1669
972,에스제이엠,123700,19.19,1.63,464,1206,1670
1630,현대자동차,005380,37.33,2.04,872,799,1671
2292,미래생명자원,218150,59.04,3.17,1083,590,1673
2343,에스피시스템스,317830,171.35,0.96,405,1270,1675
2013,아진엑스텍,059120,47.48,2.97,970,706,1676
1133,와이어블,065530,78.81,4.28,1226,450,1676
2416,포스코엠텍,009520,20.4,10.1,519,1157,1676
2173,모나리자,012690,23.28,11.62,609,1071,1680
1328,ISC,095340,60.62,3.68,1140,540,1680
1132,와이아이케이,232140,24.24,12.0,636,1048,1684
1268,신라교역,004970,19.08,1.48,457,1228,1685
1671,디케이티,290550,33.62,17.23,826,859,1685
376,한국프랜지공업,010100,9.67,5.24,1334,351,1685
2208,일신방직,003200,19.16,1.42,461,1234,1695
247,특수건설,026150,46.45,2.7,963,733,1696
2431,한네트,052600,60.64,3.54,1141,556,1697
1600,전방,000950,8.5,4.35,1254,443,1697
1843,LG생활건강,051900,35.99,17.92,855,843,1698
2181,삼화콘덴서공업,001820,29.38,14.28,738,960,1698
1022,SDN,099220,21.01,10.05,536,1163,1699
1768,인크로스,216050,35.35,17.55,853,849,1702
1258,삼성전기,009150,22.87,10.92,595,1108,1703
919,NICE,034310,43.58,2.43,945,760,1705
611,SK가스,018670,3.64,14.91,767,939,1706
889,하이제5호스팩,340120,171.61,0.65,406,1301,1707
1051,디알젬,263690,9.63,47.0,1333,376,1709
748,디지털대성,068930,21.73,10.24,561,1149,1710
1267,세하,027970,5.95,21.14,1033,677,1710
1504,펄어비스,263750,33.73,16.45,828,883,1711
2262,글로벌에스엠,900070,20.59,1.75,523,1193,1716
2166,동아쏘시오홀딩스,000640,4.63,19.87,906,811,1717
1893,에스원,012750,22.73,10.48,588,1131,1719
952,사조산업,007160,21.09,1.85,538,1182,1720
2003,심텍홀딩스,036710,4.19,18.52,891,831,1722
1645,고려신용정보,049720,8.29,39.79,1240,482,1722
2288,리노공업,058470,37.16,17.37,870,853,1723
1290,케이티,030200,9.52,4.75,1322,406,1728
1974,디와이피엔에프,104460,8.13,32.49,1234,497,1731
147,세보엠이씨,011560,9.17,4.55,1309,425,1734
1945,NHN한국사이버결제,060250,55.92,21.35,1061,674,1735
649,삼양통상,002170,3.77,14.17,772,966,1738
2356,영풍정밀,036560,9.56,4.71,1327,411,1738
1507,푸드나무,290720,26.33,11.76,679,1061,1740
321,대한제당,001790,9.76,4.8,1340,400,1740
562,풍강,093380,173.62,0.26,408,1333,1741
1707,세종메디칼,258830,196.84,1.03,480,1264,1744
683,종근당바이오,063160,70.61,3.79,1213,531,1744
720,SGA솔루션즈,184230,6.64,27.09,1122,623,1745
573,한국정보인증,053300,25.24,11.09,654,1093,1747
1992,삼목에스폼,018310,179.61,0.21,411,1341,1752
337,세방,004360,8.24,3.89,1237,515,1752
447,비트컴퓨터,032850,28.5,12.49,721,1033,1754
2165,대현,016090,9.3,4.48,1316,438,1754
1124,엠플러스,259630,26.83,11.66,685,1069,1754
211,이베스트이안스팩1호,323210,180.78,0.58,451,1305,1756
1331,KMH하이텍,052900,48.59,2.24,978,778,1756
837,이노와이어리스,073490,31.58,14.19,794,964,1758
1126,예스24,053280,1779.84,0.13,410,1348,1758
1326,GH신소재,130500,1764.01,0.12,409,1350,1759
2183,서울도시가스,017390,3.45,13.14,759,1001,1760
1634,효성티앤씨,298020,6.68,25.1,1127,633,1760
2004,쎌바이오텍,049960,69.27,3.13,1170,594,1764
2235,현대로템,064350,52.85,2.84,1043,721,1764
1851,TYM,002900,56.19,2.98,1064,704,1768
1940,HB테크놀러지,078150,48.96,2.21,981,787,1768
265,한국선재,025550,46.85,2.01,966,804,1770
1626,한화손해보험,000370,7.31,3.11,1185,597,1782
765,브리지텍,064480,51.8,2.6,1040,743,1783
564,피에스케이,319660,26.9,11.0,687,1098,1785
963,세진중공업,075580,205.36,1.19,535,1250,1785
869,코스메카코리아,241710,49.7,2.04,988,798,1786
1401,셀루메드,049180,1999.83,0.51,482,1309,1791
373,한국콜마,161890,7.27,29.27,1181,611,1792
1682,미래나노텍,095500,3.61,12.7,766,1027,1793
2237,현대위아,011210,23.86,1.96,625,1169,1794
1593,유한양행,000100,27.72,11.06,704,1095,1799
835,유진테크,084370,219.26,1.47,570,1229,1799
2276,데이타솔루션,263800,232.9,1.93,629,1171,1800
825,오텍,067170,59.34,2.86,1084,717,1801
774,세운메디칼,100700,26.25,10.64,677,1124,1801
233,케이비제20호스팩,342550,203.17,0.95,534,1272,1806
653,샘표식품,248170,6.67,20.65,1126,684,1810
481,액트로,290740,58.75,2.74,1080,731,1811
148,셀바스헬스케어,208370,71.56,3.09,1214,599,1813
1642,JYP Ent.,035900,46.15,17.29,961,857,1818
1964,대성창투,027830,58.68,2.62,1079,740,1819
1007,한진중공업,097230,7.78,27.71,1202,619,1821
2238,현대코퍼레이션,011760,4.28,15.09,895,928,1823
2242,흥국화재,000540,8.12,3.16,1232,593,1825
115,뉴인텍,012340,225.93,1.46,598,1231,1829
1317,현대백화점,069960,23.76,1.65,624,1205,1829
1298,태광산업,003240,8.43,3.26,1250,580,1830
686,진양화학,051630,79.17,3.04,1228,602,1830
1006,한일현대시멘트,006390,7.96,27.27,1211,622,1833
1271,신영증권,001720,4.95,15.34,920,915,1835
122,동구바이오제약,006620,26.4,10.14,682,1155,1837
958,삼익THK,004380,56.76,2.36,1070,768,1838
348,영보화학,014440,26.07,1.94,670,1170,1840
318,대영포장,014160,54.14,2.18,1052,789,1841
2026,에이텍,045660,29.61,10.98,741,1100,1841
1176,파크시스템스,140860,63.29,20.43,1152,691,1843
1117,엔에스,217820,27.92,10.41,708,1136,1844
1262,삼화페인트공업,000390,56.93,2.29,1072,773,1845
2418,푸른기술,094940,80.16,3.33,1272,576,1848
2429,한국전자금융,063570,56.5,2.23,1068,781,1849
260,하나금융15호스팩,341160,218.64,0.9,567,1284,1851
1550,SNT중공업,003570,23.48,1.37,616,1238,1854
1283,일진전기,103590,24.39,1.57,640,1215,1855
727,나노신소재,121600,250.49,1.77,666,1190,1856
615,국제약품,002720,84.44,3.35,1285,572,1857
1503,팜스토리,027710,4.74,14.74,912,945,1857
1542,CS홀딩스,000590,8.92,3.2,1270,587,1857
2161,대상홀딩스,084690,4.32,14.21,897,963,1860
1423,에스에이엠티,031330,5.58,17.6,1012,848,1860
522,제놀루션,225220,3.49,100.25,762,1099,1861
1487,카카오게임즈,293490,33.35,12.12,820,1042,1862
1554,경방,000050,26.09,1.76,671,1191,1862
1451,와토스코리아,079000,27.13,1.97,698,1167,1865
2296,보성파워텍,006910,55.57,2.0,1059,807,1866
1852,가온전선,000500,9.54,3.65,1325,544,1869
2061,이엠텍,091120,210.54,0.51,565,1308,1873
2095,티사이언티픽,057680,229.66,0.95,602,1273,1875
1905,일신석재,007110,230.06,1.22,627,1249,1876
1218,CJ씨푸드,011150,87.51,3.23,1292,584,1876
886,피에이치에이,043370,24.3,1.36,638,1239,1877
684,지누스,013890,32.26,11.61,805,1072,1877
449,삼성스팩2호,291230,218.78,0.5,568,1310,1878
2228,한세예스24홀딩스,016450,5.64,16.99,1016,863,1879
1842,LF,093050,24.83,1.41,644,1236,1880
993,코오롱글로벌,003070,5.96,17.83,1034,846,1880
329,롯데하이마트,071840,25.6,1.49,660,1225,1885
518,인포뱅크,039290,65.67,2.78,1158,728,1886
1576,미래에셋생명,085620,9.56,3.45,1326,564,1890
2317,슈프리마아이디,317770,59.77,2.0,1086,805,1891
545,코웰패션,033290,8.29,22.98,1241,652,1893
746,듀오백,073190,65.2,2.65,1157,737,1894
918,NAVER,035420,47.97,15.21,972,923,1895
565,피에스텍,002230,212.95,0.31,566,1330,1896
1857,넥센,005720,24.31,1.05,639,1260,1899
369,한국금융지주,071050,5.63,16.27,1015,885,1900
1080,서울반도체,046890,67.45,2.64,1162,738,1900
563,플레이디,237820,67.53,2.68,1164,736,1900
2415,파이오링크,170790,8.77,23.54,1262,644,1906
2015,알엔투테크놀로지,148250,34.43,11.67,840,1067,1907
1637,휴스틸,005010,6.43,2.13,1113,795,1908
2298,브이티지엠피,018290,275.09,1.69,710,1198,1908
1037,네이블커뮤니케이션즈,153460,62.15,2.38,1144,766,1910
2144,JB금융지주,175330,3.06,10.06,751,1162,1913
33,메리츠증권,008560,4.74,13.08,911,1003,1914
420,동국산업,005160,28.15,1.71,717,1197,1914
111,네오티스,085910,228.22,0.45,601,1314,1915
541,코리아에셋투자증권,190650,5.28,15.39,1002,914,1916
230,초록뱀컴퍼니,052300,5.2,15.25,997,920,1917
301,KPX케미칼,025000,4.2,12.7,892,1026,1918
128,디지틀조선,033130,62.64,2.32,1146,772,1918
1103,알톤스포츠,123750,9.25,29.7,1314,608,1922
2083,컬러레이,900310,4.92,13.0,918,1005,1923
501,원일특강,012620,26.64,1.23,683,1247,1930
503,윌링스,313760,247.4,0.88,647,1285,1932
1365,동아화성,041930,66.19,2.27,1159,776,1935
1404,소프트캠프,258790,47.66,14.19,971,965,1936
2150,SK디스커버리,006120,5.02,14.71,991,947,1938
1560,금호석유화학,011780,8.33,20.18,1245,695,1940
891,한국제8호스팩,310870,231.72,0.48,628,1313,1941
763,보라티알,250000,74.17,2.76,1217,729,1946
2066,인트론바이오,048530,60.55,19.89,1139,810,1949
756,리드코프,012700,4.03,11.78,890,1059,1949
2178,보해양조,000890,68.08,2.21,1166,786,1952
1417,아주IB투자,027360,9.59,26.2,1329,625,1954
167,아이즈비전,031310,4.95,12.4,919,1036,1955
1872,디와이파워,210540,5.17,14.27,995,961,1956
1959,뉴파워프라즈마,144960,8.79,20.37,1264,692,1956
2428,한국알콜,017890,5.53,14.55,1008,951,1959
2272,다우데이타,032190,5.1,14.16,994,967,1961
1977,레이,228670,44.87,12.87,953,1012,1965
2365,우원개발,046940,6.75,18.28,1130,835,1965
560,팬엔터테인먼트,068050,99.86,3.11,1369,596,1965
1865,대한화섬,003830,8.36,2.84,1247,722,1969
1512,한국큐빅,021650,6.15,16.88,1100,871,1971
1816,흥국,010240,6.09,16.61,1094,877,1971
2273,대동스틸,048470,241.63,0.32,646,1328,1974
1856,남광토건,001260,9.57,23.09,1328,649,1977
699,한국전력공사,015760,8.83,2.91,1265,713,1978
389,CS,065770,261.62,0.81,690,1289,1979
1489,케이비17호스팩,317030,253.75,0.42,667,1315,1982
36,부국증권,001270,4.7,11.58,908,1075,1983
830,위닉스,044340,9.99,24.92,1350,634,1984
1920,하이트진로홀딩스,000140,5.53,13.88,1009,975,1984
1467,이퓨쳐,134060,81.37,2.94,1277,709,1986
1121,엘오티베큠,083310,78.67,2.39,1225,762,1987
2303,빛샘전자,072950,32.85,1.91,814,1174,1988
921,SK증권,001510,33.58,1.99,824,1166,1990
705,한샘,009240,37.79,10.83,874,1117,1991
19,국동,005320,9.23,20.63,1312,686,1998
1989,비나텍,126340,55.05,14.83,1057,944,2001
1342,가온미디어,078890,33.47,1.85,821,1181,2002
1701,상아프론테크,089980,306.96,1.58,789,1213,2002
2315,솔트룩스,304100,295.28,1.11,749,1255,2004
2041,오스템,031510,34.28,1.97,836,1168,2004
625,더존비즈온,012510,57.59,15.09,1074,930,2004
146,성창오토텍,080470,75.11,2.18,1218,790,2008
862,케이비제18호스팩,323940,264.65,0.39,691,1318,2009
834,유안타제4호스팩,313750,268.83,0.41,693,1316,2009
559,팍스넷,038160,inf,424.03,1627,385,2012
1958,녹십자엠에스,142280,49.36,12.67,985,1028,2013
1067,미코,059090,40.72,11.34,929,1084,2013
193,영화테크,265560,280.48,0.9,731,1283,2014
85,현대건설,000720,34.12,1.84,833,1184,2017
1748,와이지엔터테인먼트,122870,86.79,2.74,1291,730,2021
443,미래에셋벤처투자,100790,7.84,19.13,1206,819,2025
164,아이씨디,040910,9.72,20.49,1336,690,2026
676,이구산업,025820,34.92,1.86,847,1179,2026
320,대한방직,001070,79.01,2.04,1227,800,2027
2306,상상인이안제2호스팩,329560,275.59,0.4,711,1317,2028
339,세우글로벌,013000,80.67,2.44,1275,757,2032
805,에스제이그룹,306040,9.9,20.6,1346,687,2033
747,디지아이,043360,32.64,1.49,810,1226,2036
1933,현대오토에버,307950,43.96,11.09,946,1092,2038
1120,엘앤씨바이오,290650,70.17,18.64,1212,829,2041
2321,싸이맥스,160980,9.84,20.05,1343,699,2042
2404,코윈테크,282880,87.65,2.51,1293,751,2044
2199,우진아이엔에스,010400,34.87,1.69,846,1199,2045
81,한솔로지스틱스,009180,7.32,17.09,1186,861,2047
2274,대신밸런스제8호스팩,336570,284.43,0.39,732,1319,2051
1217,CJ,001040,37.91,1.89,876,1177,2053
1584,성창기업지주,000180,30.73,0.96,786,1269,2055
1230,SK네트웍스,001740,34.95,1.63,848,1207,2055
2424,하이록코리아,013030,34.67,1.57,844,1214,2058
782,슈피겐코리아,192440,7.57,16.96,1196,865,2061
1167,큐캐피탈,016600,39.1,1.87,884,1178,2062
333,사조대림,003960,4.42,10.02,900,1164,2064
2051,윙입푸드,900340,5.22,11.7,999,1065,2064
364,쿠쿠홀딩스,192400,6.66,14.88,1124,941,2065
175,에스앤더블류,103230,35.79,1.58,854,1212,2066
2371,유진스팩5호,331380,290.09,0.38,746,1320,2066
675,유화증권,003460,32.79,1.12,813,1253,2066
2198,우리종금,010050,6.1,14.04,1095,972,2067
570,하나금융14호스팩,332710,294.27,0.38,747,1321,2068
1056,로지시스,067730,93.62,2.9,1356,714,2070
1624,한솔홈데코,025750,294.63,0.38,748,1322,2070
2388,제이엔케이히터,126880,88.97,2.27,1298,774,2072
2263,금화피에스시,036190,5.83,12.07,1028,1045,2073
1197,화일약품,061250,80.31,2.03,1273,801,2074
1168,크리스에프앤씨,110790,7.86,16.91,1208,869,2077
1926,한미약품,128940,370.15,1.65,877,1204,2081
263,한국경제TV,039340,6.87,14.63,1135,949,2084
1270,신영와코루,005800,32.2,0.92,804,1281,2085
2110,한양이엔지,045100,6.38,13.85,1110,977,2087
59,유나이티드,033270,40.51,10.01,926,1165,2091
1723,아이디스홀딩스,054800,39.12,1.61,885,1209,2094
2224,하이브,352820,56.35,12.52,1065,1032,2097
110,네오위즈,095660,8.17,16.95,1236,866,2102
1868,동방,004140,6.11,12.87,1096,1011,2107
997,페이퍼코리아,001020,350.82,1.18,857,1251,2108
1932,현대약품,004310,94.81,2.52,1358,750,2108
2014,아톤,158430,96.01,2.54,1362,747,2109
504,유니테스트,086390,346.56,1.06,850,1259,2109
1464,이엠네트웍스,087730,inf,3839.05,1626,483,2109
1393,상상인,038540,5.73,11.17,1022,1090,2112
182,에이티넘인베스트,021080,8.52,17.04,1255,862,2117
1282,유니온,000910,6.41,12.93,1112,1008,2120
1880,사조오양,006090,5.02,10.48,990,1132,2122
2325,씨에스베어링,297090,56.44,11.82,1066,1058,2124
1754,위니아딤채,071460,7.55,15.03,1195,932,2127
207,유진스팩4호,321260,319.84,0.33,800,1327,2127
892,한국캐피탈,023760,5.7,10.87,1020,1112,2132
502,윈하이텍,192390,40.51,1.6,925,1210,2135
819,엔텔스,069410,8.44,16.15,1252,889,2141
135,미래에셋대우스팩3호,328380,322.49,0.33,816,1326,2142
70,종근당홀딩스,001630,8.12,15.59,1233,911,2144
1846,SKC,011790,95.07,2.21,1360,785,2145
43,상상인증권,001290,40.66,1.54,928,1219,2147
2344,에이에프더블류,312610,99.92,2.24,1370,779,2149
1242,대한제강,084010,5.26,10.21,1001,1151,2152
1341,iMBC,052220,94.08,2.06,1357,797,2154
1468,이화공영,001840,350.64,0.7,856,1298,2154
73,키다리스튜디오,020120,3238.63,0.22,817,1339,2156
30,락앤락,115390,46.77,1.74,964,1194,2158
680,제이에스코퍼레이션,194370,42.45,1.54,940,1218,2158
981,유니드,014830,5.58,10.29,1013,1146,2159
331,보락,002760,372.75,0.9,878,1282,2160
1221,DL,000210,6.34,11.84,1107,1057,2164
2345,에이치시티,072990,9.98,19.16,1349,818,2167
935,대한전선,001440,396.78,0.92,889,1279,2168
1944,NE능률,053290,46.45,1.61,962,1208,2170
74,태경산업,015890,46.07,1.59,960,1211,2171
2149,NH투자증권,005940,5.88,10.32,1030,1143,2173
442,무림SP,001810,39.63,0.86,888,1286,2174
1892,애경유화,161000,6.45,11.72,1114,1062,2176
276,화성밸브,039610,48.26,1.68,977,1202,2179
1718,쎄니트,037760,6.67,11.85,1125,1056,2181
2319,신신제약,002800,382.34,0.64,882,1302,2184
980,우진플라임,049800,7.8,13.7,1203,981,2184
535,천보,278280,66.7,12.57,1160,1031,2191
496,우리손에프앤지,073560,6.31,11.27,1106,1086,2192
2200,웅진씽크빅,095720,354.6,0.23,858,1338,2196
1347,국보디자인,066620,7.18,12.71,1176,1025,2201
635,롯데정밀화학,004000,7.16,12.65,1174,1029,2203
1745,오킨스전자,080580,477.2,1.47,974,1230,2204
895,현우산업,092300,48.8,1.49,979,1227,2206
881,파워넷,037030,384.45,0.33,883,1324,2207
2018,액토즈소프트,052790,6.87,11.58,1134,1074,2208
2186,신흥,004080,8.49,14.45,1253,955,2208
1566,더블유게임즈,192080,9.82,16.94,1342,867,2209
1336,SK5호스팩,337450,377.0,0.28,880,1332,2212
453,삼지전자,037460,7.49,12.77,1191,1022,2213
969,아모레퍼시픽,090430,404.68,0.78,931,1290,2221
1961,대륙제관,004780,6.23,10.79,1103,1121,2224
920,NI스틸,008260,6.05,10.45,1091,1134,2225
770,삼천리자전거,024950,9.07,15.21,1303,922,2225
241,코프라,126600,6.9,11.19,1136,1089,2225
1555,고려제강,002240,40.15,0.62,923,1304,2227
1939,CMG제약,058820,3734.0,0.12,879,1349,2228
6,KG케미칼,001390,7.19,11.94,1178,1053,2231
1938,CJ ENM,035760,53.74,1.78,1048,1189,2237
1239,대상,001680,7.5,12.02,1192,1046,2238
964,셀트리온,068270,96.59,16.68,1363,876,2239
41,삼영화학공업,003720,410.89,0.49,938,1311,2249
1245,만호제강,001080,44.4,0.55,950,1307,2257
1970,동양이엔피,079960,6.28,10.14,1105,1156,2261
745,동일기연,032960,53.88,1.53,1049,1220,2269
608,SHD,001770,50.68,1.42,1035,1235,2270
194,예스티,122640,453.17,0.48,958,1312,2270
1134,우리산업홀딩스,072470,54.44,1.54,1054,1217,2271
326,디씨엠,024090,7.18,10.98,1177,1101,2278
2100,플랜티넷,075130,54.52,1.52,1055,1223,2278
1294,크라운제과,264900,7.29,11.0,1182,1097,2279
24,대우건설,047040,7.3,11.06,1183,1096,2279
2012,아이원스,114810,458.65,0.33,959,1325,2284
1567,동부건설,005960,6.87,10.1,1133,1158,2291
298,CJ제일제당,097950,9.1,13.5,1306,989,2295
637,만도,204320,476.93,0.37,973,1323,2296
363,코오롱플라스틱,138490,57.0,1.51,1073,1224,2297
1979,매일유업,267980,9.51,13.67,1321,982,2303
1096,아세아텍,050860,51.39,1.0,1039,1267,2306
1155,젬백스,082270,574.76,1.44,1075,1233,2308
1643,RFHIC,218410,526.87,1.02,1044,1265,2309
725,국일신동,060480,464.97,0.2,967,1342,2309
2112,현대에이치티,039010,7.67,10.89,1200,1110,2310
1785,큐렉소,060280,502.16,0.94,1037,1275,2312
674,유니켐,011330,8.88,12.01,1268,1047,2315
2070,일진파워,094820,7.84,10.85,1207,1114,2321
209,유티아이,179900,533.1,0.92,1050,1278,2328
959,삼화왕관,004450,56.76,1.03,1069,1262,2331
893,한일네트웍스,046110,7.82,10.56,1205,1127,2332
944,롯데케미칼,011170,59.7,1.22,1085,1248,2333
2221,케이티앤지,033780,9.74,13.22,1338,998,2336
1263,샘표,007540,7.88,10.5,1209,1129,2338
219,자이글,234920,60.5,1.67,1137,1203,2340
691,텔코웨어,078000,62.88,1.69,1147,1200,2347
1951,구영테크,053270,59.86,1.03,1087,1263,2350
1668,디에이치피코리아,131030,9.61,12.71,1331,1024,2355
1521,휴온스글로벌,084110,8.24,10.79,1238,1120,2358
642,미원화학,134380,9.88,12.81,1345,1018,2363
667,아모레퍼시픽그룹,002790,507.65,0.31,1038,1329,2367
1591,엔에스쇼핑,138250,63.16,1.53,1151,1221,2372
1517,해성산업,034810,0.49,,1,2372,2373
379,해태제과식품,101530,8.75,10.84,1260,1115,2375
692,티와이홀딩스,363280,1.05,,3,2373,2376
324,동원F&B,049770,8.86,10.91,1267,1109,2376
433,매일홀딩스,005990,58.79,0.68,1081,1299,2380
0,DRB동일,004840,58.97,0.66,1082,1300,2382
604,MH에탄올,023150,9.09,11.49,1305,1079,2384
1010,현대에너지솔루션,322000,71.71,1.93,1215,1172,2387
1764,이니텍,053350,61.78,1.27,1143,1245,2388
561,펌텍코리아,251970,9.98,12.15,1348,1041,2389
105,그리티,204020,62.89,1.31,1148,1243,2391
1949,SK6호스팩,340350,554.9,0.3,1062,1331,2393
863,케이비제19호스팩,330990,539.97,0.2,1051,1343,2394
439,멕아이씨에스,058110,9.93,113.22,1347,1050,2397
2302,비아트론,141000,8.99,10.57,1271,1126,2397
378,한올바이오파마,009420,99.12,12.29,1366,1038,2404
672,엔에이치엔,181710,68.06,1.35,1165,1240,2405
1082,서원인텍,093920,8.55,10.08,1256,1159,2415
1186,피엔에이치테크,239890,inf,117.77,1377,1049,2426
1259,삼양패키징,272550,9.35,10.88,1318,1111,2429
1956,나우IB,293580,9.02,10.37,1301,1139,2440
1770,제넥신,095700,108.19,,66,2374,2440
984,이건산업,008250,69.52,0.96,1171,1271,2442
678,일성신약,003120,68.31,0.93,1167,1276,2443
154,승일,049830,62.18,0.57,1145,1306,2451
1415,아이컴포넌트,059100,77.76,1.38,1222,1237,2459
1475,정원엔시스,045510,83.87,1.9,1283,1176,2459
847,인텔리안테크,189300,687.16,0.74,1169,1294,2463
84,한화생명,088350,9.01,1.9,1300,1175,2475
2082,창해에탄올,004650,9.54,10.19,1324,1154,2478
1437,에프엔에스테크,083500,11.85,,107,2375,2482
2434,현대사료,016790,632.42,0.22,1153,1340,2493
471,신한제6호스팩,333050,622.82,0.18,1150,1344,2494
1196,헝셩그룹,900270,9.78,1.83,1341,1185,2526
322,대한해운,005880,84.53,1.1,1286,1256,2542
2167,동아지질,028100,88.29,1.06,1295,1258,2553
2039,오리콤,010470,83.01,0.93,1280,1277,2557
235,케이프이에스제4호,347140,1262.41,,185,2376,2561
986,이연제약,102460,99.29,1.71,1368,1196,2564
733,다보링크,340360,767.97,0.13,1221,1347,2568
1650,기산텔레콤,035460,778.21,0.15,1223,1345,2568
472,씨앤투스성진,352700,,75.7,2447,123,2570
1314,한진,002320,83.21,0.74,1282,1293,2575
215,이지바이오,353810,13.61,,215,2377,2592
2203,유유제약,000220,92.32,1.26,1354,1246,2600
610,SK,034730,90.08,1.11,1351,1254,2605
1421,에너토크,019990,92.34,1.1,1355,1257,2612
66,제일약품,271980,133.1,,236,2378,2614
1332,KT서브마린,060370,97.15,1.17,1364,1252,2616
807,에스퓨얼셀,288620,139.54,,244,2379,2623
1509,프리엠스,053160,845.1,0.25,1288,1335,2623
1015,효성첨단소재,298050,8489.96,0.03,1289,1353,2642
142,삼아제약,009300,851.21,0.07,1290,1352,2642
1296,크래프톤,259960,,61.86,2446,197,2643
613,STX중공업,071970,99.2,0.73,1367,1295,2662
1814,휴마시스,205470,14.8,,284,2380,2664
1085,세중,039310,97.43,0.63,1365,1303,2668
126,디엔에프,092070,15.19,,304,2381,2685
1066,모헨즈,006920,956.76,0.24,1361,1336,2697
1809,한화에스비아이스팩,317320,947.84,0.14,1359,1346,2705
2037,오로스테크놀로지,322310,,5.81,2445,301,2746
467,솔브레인,357780,16.83,,371,2382,2753
396,PN풍년,024940,17.03,,381,2383,2764
878,티엘비,356860,18.04,,412,2384,2796
1972,디스플레이텍,066670,18.29,,425,2385,2810
1137,원바이오젠,307280,,44.34,2444,380,2824
965,솔루엠,248070,,43.26,2443,384,2827
1665,드림씨아이에스,223250,19.95,,479,2386,2865
992,케이씨씨글라스,344820,2.49,,491,2387,2878
2075,젠큐릭스,229000,2.94,,509,2388,2897
2126,시큐센,232830,inf,-inf,1400,1508,2908
2079,지스마트글로벌,114570,inf,-inf,1399,1510,2909
587,미애부,225850,inf,-inf,1402,1507,2909
2128,에스엔피제네틱스,086460,inf,-inf,1398,1512,2910
1792,티앤엘,340570,inf,-inf,1397,1515,2912
552,클리노믹스,352770,inf,-inf,1395,1518,2913
2127,씨엔티드림,286000,inf,-inf,1393,1522,2915
286,선바이오,067370,inf,-inf,1372,1552,2924
598,펨토바이오메드,327610,inf,-inf,1373,1555,2928
2046,원티드랩,376980,inf,-inf,1405,1523,2928
1166,쿠콘,294570,,36.49,2442,487,2929
2116,KC산업,112190,inf,-inf,1375,1560,2935
547,큐라클,365270,inf,-inf,1379,1558,2937
282,다이노나,086080,inf,-inf,1385,1553,2938
2117,나우코스,257990,inf,-inf,1387,1551,2938
1763,이노뎁,303530,inf,-inf,1384,1556,2940
2448,케어룸의료산업,327970,inf,-inf,1424,1517,2941
2093,코퍼스코리아,322780,inf,-inf,1396,1546,2942
2054,유일에너테크,340930,,30.63,2441,501,2942
287,씨앗,103660,inf,-inf,1434,1509,2943
1536,이비테크,208850,inf,-inf,1546,1401,2947
899,씨앤에스링크,245450,inf,-inf,1550,1397,2947
1212,엘에이티,311060,inf,-inf,1549,1398,2947
1209,안지오랩,251280,inf,-inf,1548,1399,2947
1143,유진스팩6호,373340,inf,-inf,1547,1400,2947
1525,골프존데카,183410,inf,-inf,1544,1403,2947
1526,네추럴FNP,086220,inf,-inf,1543,1404,2947
2123,비플라이소프트,148780,inf,-inf,1445,1502,2947
1608,코람코에너지리츠,357120,inf,-inf,1545,1402,2947
900,에스제이켐,217910,inf,-inf,1552,1396,2948
901,이십일스토어,270020,inf,-inf,1553,1395,2948
2453,한국미라클피플사,331660,inf,-inf,1555,1394,2949
1228,NH프라임리츠,338100,inf,-inf,1556,1393,2949
1836,파워풀엑스,266870,inf,-inf,1420,1530,2950
2442,에이펙스인텍,207490,inf,-inf,1421,1529,2950
1215,지오씨,135160,inf,-inf,1558,1392,2950
1530,비엔디생활건강,215050,inf,-inf,1560,1391,2951
1902,이지스밸류플러스리츠,334890,inf,-inf,1418,1535,2953
1835,탑선,180060,inf,-inf,1426,1527,2953
2119,대동고려삼,178600,inf,-inf,1416,1538,2954
2351,엔젠바이오,354200,inf,-inf,1411,1544,2955
898,무진메디,322970,inf,-inf,1567,1390,2957
2118,노브메타파마,229500,inf,-inf,1428,1532,2960
94,HK이노엔,195940,,3.83,2440,521,2961
1741,엠로,058970,inf,-inf,1391,1570,2961
1832,유니포인트,121060,inf,-inf,1392,1569,2961
1528,루켄테크놀러지스,162120,inf,-inf,1572,1389,2961
2130,엔솔바이오사이언스,140610,inf,-inf,1430,1534,2964
1919,프레스티지바이오파마,950210,inf,-inf,1431,1537,2968
2125,시그넷이브이,260870,inf,-inf,1432,1541,2973
1527,데이터스트림즈,199150,inf,-inf,1571,1405,2976
1210,엔에스엠,238170,inf,-inf,1575,1406,2981
2040,오비고,352910,inf,-inf,1460,1524,2984
1680,모비릭스,348030,inf,-inf,1576,1408,2984
2129,에이비온,203400,inf,-inf,1461,1525,2986
1211,엔에스컴퍼니,224760,inf,-inf,1540,1447,2987
645,삼성바이오로직스,207940,226.8,,600,2389,2989
903,인카금융서비스,211050,inf,-inf,1636,1354,2990
283,다이오진,271850,inf,-inf,1465,1526,2991
902,이엠티,232530,inf,-inf,1637,1355,2992
1848,SK아이이테크놀로지,361610,inf,-inf,1635,1358,2993
2132,인바이츠바이오코아,216400,inf,-inf,1638,1356,2994
1540,피엔아이컴퍼니,242350,inf,-inf,1634,1360,2994
1824,바이오인프라생명과학,266470,inf,-inf,1492,1505,2997
2444,원텍,216280,inf,-inf,1640,1357,2997
2443,오션스톤,329020,inf,-inf,1436,1563,2999
1537,청광건설,140290,inf,-inf,1613,1387,3000
284,대주이엔티,114920,inf,-inf,1469,1531,3000
590,바이옵트로,222160,inf,-inf,1494,1506,3000
1524,EMB,278990,inf,-inf,1577,1423,3000
2120,더콘텐츠온,302920,inf,-inf,1447,1554,3001
2133,인터코스,240340,inf,-inf,1643,1359,3002
1834,제노텍,066830,inf,-inf,1474,1528,3002
80,한국패러랠,168490,inf,-inf,1462,1543,3005
2441,에스케이씨에스,224020,inf,-inf,1645,1361,3006
597,틸론,217880,inf,-inf,1642,1367,3009
2121,루트락,253610,inf,-inf,1499,1511,3010
1385,보광산업,225530,23.58,,620,2390,3010
1773,제일전기공업,199820,inf,-inf,1649,1362,3011
2447,지앤이헬스케어,299480,inf,-inf,1650,1363,3013
1823,미래엔에듀파트너,208890,inf,-inf,1480,1533,3013
1558,교촌에프앤비,339770,inf,-inf,1625,1388,3013
2452,플럼라인생명과학,222670,inf,-inf,1501,1513,3014
1833,이성씨엔아이,379390,inf,-inf,1651,1364,3015
2449,코셋,189350,inf,-inf,1513,1503,3016
1822,로보쓰리,238500,inf,-inf,1502,1514,3016
2131,엠앤씨생명과학,225860,inf,-inf,1652,1365,3017
1821,렌딩머신,179720,inf,-inf,1653,1366,3019
52,에스디바이오센서,137310,inf,-inf,1472,1547,3019
2451,툴젠,199800,inf,-inf,1505,1516,3021
2450,타임기술,318660,inf,-inf,1483,1539,3022
2324,씨앤씨인터내셔널,352480,inf,-inf,1487,1536,3023
593,에이치엔에스하이텍,044990,inf,-inf,1484,1540,3024
2122,볼빅,206950,inf,-inf,1448,1577,3025
1910,카카오뱅크,323410,inf,-inf,1657,1369,3026
1756,위드텍,348350,inf,-inf,1508,1519,3027
1673,라온테크,232680,inf,-inf,1605,1422,3027
2437,나라소프트,288490,inf,-inf,1485,1542,3027
1819,듀켐바이오,176750,inf,-inf,1658,1370,3028
2233,한컴라이프케어,372910,inf,-inf,1661,1368,3029
2134,질경이,233990,inf,-inf,1509,1520,3029
1699,삼성머스트스팩5호,380320,inf,-inf,1608,1421,3029
1072,바이브컴퍼니,301300,inf,-inf,1610,1419,3029
1693,비올,335890,inf,-inf,1609,1420,3029
1207,씨알푸드,236030,inf,-inf,1614,1417,3031
1505,포인트모바일,318020,inf,-inf,1624,1407,3031
945,맵스리얼티1,094800,inf,-inf,1617,1414,3031
285,명진홀딩스,267060,inf,-inf,1510,1521,3031
946,명신산업,009900,inf,-inf,1619,1412,3031
949,바다로19호,155900,inf,-inf,1618,1413,3031
1202,도부마스크,227420,inf,-inf,1615,1416,3031
1529,블루탑,191600,inf,-inf,1616,1415,3031
1654,네패스아크,330860,inf,-inf,1623,1409,3032
858,카이노스메드,284620,inf,-inf,1621,1411,3032
1646,고바이오랩,348150,inf,-inf,1622,1410,3032
1431,에이프로,262260,241.45,,645,2391,3036
465,손오공,066910,inf,-8.28,1406,1634,3040
1539,프로테옴텍,303360,inf,-inf,1542,1500,3042
1213,유비온,084440,inf,-inf,1539,1504,3043
2062,이원컴포텍,088290,inf,-98.76,1463,1580,3043
476,아모텍,052710,inf,-8.67,1419,1626,3045
2031,엔비티,236810,inf,-inf,1663,1385,3048
434,맥스트,377030,inf,-inf,1666,1384,3050
2034,엘비루셈,376190,inf,-inf,1667,1383,3050
2439,메디젠휴먼케어,236340,inf,-inf,1669,1382,3051
2103,하이제6호스팩,377400,inf,-inf,1670,1381,3051
480,아이퀘스트,262840,,28.85,2439,612,3051
1686,바이오리더스,142760,inf,-77.68,1410,1642,3052
1046,덕산테코피아,317330,25.66,,662,2392,3054
2135,크로넥스,215570,inf,-inf,1674,1380,3054
1728,에브리봇,270660,inf,-inf,1675,1379,3054
2445,원포유,122830,inf,-inf,1676,1378,3054
1830,에스엠비나,299670,inf,-inf,1677,1377,3054
585,단디바이오,343090,inf,-inf,1681,1374,3055
1739,엔에프씨,265740,inf,-inf,1680,1375,3055
1829,에스에이티이엔지,158300,inf,-inf,1683,1373,3056
2438,래몽래인,200350,inf,-inf,1512,1545,3057
2440,엄지하우스,224810,inf,-inf,1685,1372,3057
2205,이지스레지던스리츠,350520,inf,-inf,1686,1371,3057
1522,휴온스블러썸,263920,inf,-80.76,1439,1618,3057
1688,베스파,299910,inf,-79.1,1422,1641,3063
584,노드메이슨,317860,inf,-inf,1687,1376,3063
1704,석경에이티,357550,inf,-inf,1678,1386,3064
2068,일승,333430,,24.6,2438,637,3075
1601,제이알글로벌리츠,348950,inf,-inf,1529,1549,3078
1206,썬테크,217320,inf,-inf,1533,1548,3081
1205,빅텐츠,210120,inf,-inf,1531,1550,3081
2124,뿌리깊은나무들,266170,inf,-inf,1514,1568,3082
1122,엠브레인,169330,,23.53,2437,645,3082
1533,에스엘에스바이오,246250,inf,-inf,1525,1557,3082
772,서산,079650,inf,-9.69,1488,1595,3083
1208,아퓨어스,149300,inf,-inf,1526,1559,3085
1086,세틀뱅크,234340,27.02,,694,2393,3087
1203,디피코,163430,inf,-inf,1527,1561,3088
1535,유엑스엔,337840,inf,-inf,1524,1564,3088
1594,이리츠코크렙,088260,inf,-inf,1528,1562,3090
1188,피플바이오,304840,inf,-inf,1518,1572,3090
1087,센코,347000,inf,-inf,1519,1573,3092
1476,제노코,361390,,22.71,2436,658,3094
1531,아이케이세미콘,149010,inf,-inf,1520,1574,3094
897,럭스피아,092590,inf,-inf,1521,1575,3096
1214,이앤에치,341310,inf,-inf,1532,1565,3097
483,에스에스알,275630,inf,-6.09,1381,1718,3099
1028,강원,114190,inf,-65.28,1407,1692,3099
1532,애드바이오텍,179530,inf,-inf,1534,1566,3100
1204,메디쎄이,200580,inf,-inf,1523,1578,3101
438,메타바이오메드,059210,inf,-8.09,1464,1638,3102
1617,하이골드3호,153360,inf,-inf,1537,1567,3104
569,핑거,163730,,21.55,2435,670,3105
595,테크엔,308700,inf,-inf,1689,1418,3107
787,신도기연,290520,inf,-8.05,1470,1639,3109
1618,한국ANKOR유전,152550,inf,-inf,1538,1571,3109
1538,폭스소프트,354230,inf,-inf,1536,1576,3112
2136,파마리서치바이오,217950,inf,-inf,1688,1424,3112
1534,엔지브이아이,093510,inf,-inf,1535,1579,3114
2446,위월드,140660,inf,-inf,1690,1426,3116
1377,마이더스AI,222810,inf,-58.89,1390,1728,3118
544,코아시아,045970,inf,-6.09,1401,1719,3120
1864,대한항공,003490,inf,-7.22,1444,1676,3120
1908,주연테크,044380,inf,-5.86,1376,1755,3131
1442,엠에스오토텍,123040,inf,-87.38,1522,1610,3132
2137,판도라티비,202960,inf,-inf,1720,1425,3145
2174,무림페이퍼,009200,inf,-9.21,1541,1605,3146
412,뉴로스,126870,inf,-96.76,1565,1583,3148
749,디티앤씨,187220,inf,-6.59,1440,1710,3150
448,삼륭물산,014970,inf,-7.99,1497,1654,3151
1873,롯데리츠,330590,inf,-inf,1655,1501,3156
654,서연이화,200880,inf,-6.8,1452,1705,3157
586,메디안디노스틱,233250,inf,-inf,1694,1464,3158
159,쎄미시스코,136510,inf,-48.29,1371,1796,3167
2035,엘앤에프,066970,inf,-9.39,1574,1599,3173
1862,대유플러스,000300,inf,-9.07,1568,1607,3175
1827,스템랩,258540,inf,-inf,1695,1480,3175
1820,라이프사이언스테크놀로지,285770,inf,-inf,1696,1479,3175
1817,굿센,243870,inf,-inf,1697,1478,3175
596,테크트랜스,258050,inf,-inf,1698,1477,3175
813,에코플라스틱,038110,inf,-5.9,1423,1754,3177
1500,투비소프트,079970,inf,-60.79,1481,1698,3179
594,이노벡스,279060,inf,-inf,1704,1476,3180
909,ESR켄달스퀘어리츠,365550,inf,-inf,1707,1475,3182
2138,피노텍,150440,inf,-inf,1709,1474,3183
1831,에이원알폼,234070,inf,-inf,1711,1473,3184
905,한중엔시에스,107640,inf,-inf,1712,1472,3184
853,제주맥주,276730,inf,-inf,1714,1471,3185
1711,셀리드,299660,inf,-8.37,1554,1632,3186
609,SH에너지화학,002360,inf,-7.29,1517,1671,3188
780,수산아이앤티,050960,31.58,,795,2394,3189
2141,F&F,383220,inf,-inf,1721,1470,3191
904,태양기계,116100,inf,-inf,1723,1469,3192
1828,에스앤디,260970,inf,-inf,1724,1468,3192
1826,수프로,185190,inf,-inf,1730,1466,3196
2421,플래티어,367000,inf,-inf,1729,1467,3196
2194,엔에이치스팩19호,380440,inf,-inf,1733,1465,3198
157,쌍용정보통신,010280,inf,-42.16,1383,1821,3204
2191,에이리츠,140910,inf,-inf,1732,1481,3213
1446,올리패스,244460,inf,-77.11,1570,1643,3213
1394,샘코,263540,inf,-71.55,1562,1652,3214
1855,광전자,017900,inf,-7.56,1551,1664,3215
1825,셀젠텍,258250,inf,-inf,1734,1482,3216
1602,제이콘텐트리,036420,inf,-52.61,1471,1745,3216
1727,압타바이오,293780,inf,-5.33,1442,1775,3217
752,레고켐바이오,141080,inf,-6.19,1503,1716,3219
592,앙츠,267810,inf,-inf,1735,1484,3219
1492,코다코,046070,inf,-75.32,1573,1646,3219
1474,장원테크,174880,inf,-88.16,1611,1609,3220
1516,한프,066110,inf,-48.77,1427,1795,3222
1313,한전기술,052690,33.84,,829,2395,3224
2389,제일테크노스,038010,inf,-5.99,1478,1752,3230
482,앱코,129890,inf,-inf,1736,1499,3235
591,아이피몬스터,223220,inf,-inf,1737,1498,3235
589,바이오프로테크,199290,inf,-inf,1738,1497,3235
1818,데이드림엔터,348840,inf,-inf,1739,1496,3235
850,제이시스메디칼,287410,,190.55,2434,808,3242
588,바이오시네틱스,281310,inf,-inf,1753,1495,3248
13,STX,011810,inf,-48.03,1451,1798,3249
2420,프레스티지바이오로직스,334970,inf,-inf,1755,1494,3249
2251,S&K폴리텍,091340,inf,-6.92,1559,1702,3261
815,엔브이에이치코리아,067570,inf,-9.91,1673,1590,3263
722,WI,073570,inf,-8.45,1647,1631,3278
28,두산중공업,034020,inf,-37.2,1409,1873,3282
639,메타랩스,090370,inf,-33.92,1386,1897,3283
34,명문제약,017180,inf,-33.77,1389,1899,3288
32,마니커,027740,inf,-44.05,1476,1814,3290
53,에이블씨엔씨,078520,inf,-43.75,1477,1816,3293
1614,티웨이항공,091810,inf,-90.15,1706,1589,3295
123,디에이테크놀로지,196490,inf,-36.09,1415,1881,3296
1320,화성산업,002460,4.67,,907,2396,3303
1052,디에스티,033430,inf,-71.8,1654,1651,3305
353,이수화학,005950,inf,-31.08,1394,1912,3306
100,강스템바이오텍,217730,inf,-30.2,1388,1919,3307
2363,옴니시스템,057540,inf,-4.76,1475,1835,3310
10,LG헬로비전,037560,inf,-39.53,1454,1856,3310
186,엔시트론,101400,inf,-41.45,1486,1824,3310
1411,싸이버원,356890,,16.6,2433,878,3311
1372,랩지노믹스,084650,4.91,,915,2397,3312
734,다산네트웍스,039560,inf,-8.47,1692,1629,3321
402,경남제약헬스케어,223310,inf,-34.73,1435,1890,3325
2353,엘티씨,170920,inf,-4.72,1489,1837,3326
258,피에스엠씨,024850,inf,-35.84,1446,1883,3329
239,코스온,069110,inf,-36.24,1459,1879,3338
399,THQ,192410,inf,-33.11,1437,1903,3340
2030,엑스큐어,070300,inf,-3.68,1404,1937,3341
662,신성이엔지,011930,inf,-8.77,1725,1622,3347
1889,쌍방울,102280,inf,-8.46,1718,1630,3348
120,대한그린파워,060900,inf,-76.61,1705,1645,3350
664,신세계푸드,031440,inf,-7.35,1682,1670,3352
172,애니플러스,310200,inf,-33.65,1456,1900,3356
1934,현대중공업지주,267250,inf,-8.12,1719,1637,3356
681,제이준코스메틱,025620,inf,-37.83,1500,1867,3367
275,현대바이오랜드,052260,inf,-9.25,1764,1604,3368
1976,러셀,217500,48.19,,976,2398,3374
325,동원금속,018500,inf,-55.39,1639,1735,3374
1097,아시아종묘,154030,inf,-9.55,1781,1598,3379
191,엠벤처투자,019590,inf,-28.45,1408,1977,3385
1450,와이팜,332570,49.41,,986,2399,3385
1255,삼부토건,001470,inf,-8.73,1763,1623,3386
1870,동양피스톤,092780,inf,-7.29,1715,1672,3387
338,세아홀딩스,058650,inf,-8.48,1762,1628,3390
218,자비스,254120,inf,-52.35,1644,1747,3391
98,UCI,038340,inf,-55.57,1662,1734,3396
273,현대무벡스,319400,,14.08,2431,970,3401
636,롯데푸드,002270,5.34,,1004,2400,3404
2284,라이프시맨틱스,347700,,1387.54,2432,973,3405
826,와이즈버즈,273060,inf,-7.62,1744,1661,3405
1458,유아이디,069330,inf,-67.02,1722,1687,3409
1767,인콘,083640,inf,-5.64,1646,1765,3411
367,티비에이치글로벌,084870,inf,-33.15,1511,1902,3413
1113,에이티세미콘,089530,inf,-80.56,1799,1619,3418
1912,케이비아이동국실업,001620,inf,-6.83,1716,1703,3419
1172,티엘아이,062860,inf,-8.89,1800,1620,3420
1923,한국조선해양,009540,inf,-7.42,1754,1668,3422
1549,SK바이오사이언스,302440,,13.25,2430,995,3425
1966,대창스틸,140520,inf,-7.09,1747,1681,3428
2229,한일시멘트,300720,5.85,,1029,2401,3430
1002,한국화장품제조,003350,inf,-8.71,1806,1625,3431
1100,아이진,185490,inf,-93.1,1846,1586,3432
1119,엔피디,198080,inf,-7.59,1774,1662,3436
1904,일동제약,249420,inf,-5.13,1664,1781,3445
2454,휴벡셀,212310,inf,-inf,1953,1493,3446
1277,엘브이엠씨,900140,inf,-7.2,1770,1677,3447
192,엠젠플러스,032790,inf,-29.09,1479,1969,3448
1655,녹원씨엔아이,065560,inf,-9.59,1854,1597,3451
1439,엔바이오니아,317870,inf,-9.37,1851,1600,3451
266,한국테크놀로지,053590,inf,-53.33,1713,1743,3456
2099,포티스,141020,inf,-5.8,1700,1759,3459
1129,옵트론텍,082210,inf,-7.51,1797,1665,3462
767,비즈니스온,138580,56.09,,1063,2402,3465
1426,에이비프로바이오,195990,inf,-45.97,1660,1806,3466
1954,나노캠텍,091970,inf,-6.1,1751,1717,3468
1674,라파스,214260,inf,-9.87,1878,1592,3470
170,알에프세미,096610,inf,-46.59,1668,1803,3471
309,강원랜드,035250,inf,-7.92,1823,1656,3479
1274,아시아나IDT,267850,inf,-6.03,1760,1721,3481
1034,내츄럴엔도텍,168330,inf,-8.71,1860,1624,3484
1675,리노스,039980,inf,-7.96,1830,1655,3485
1236,남양유업,003920,inf,-6.04,1768,1720,3488
1429,에이치엔티,176440,inf,-51.5,1749,1748,3497
556,파멥신,208340,inf,-54.06,1761,1736,3497
2396,천랩,311690,inf,-26.82,1516,1989,3505
1136,우진비앤지,018620,inf,-7.23,1832,1675,3507
1173,파라다이스,034230,inf,-9.8,1914,1594,3508
1130,옵티팜,153710,inf,-6.78,1803,1706,3509
1128,오하임아이엔티,309930,inf,-inf,2020,1492,3512
1459,유아이엘,049520,inf,-6.65,1807,1708,3515
441,모두투어,080160,inf,-73.08,1868,1648,3516
721,SM Life Design,063440,inf,-6.42,1805,1714,3519
2277,덱스터,206560,inf,-5.4,1752,1771,3523
93,ES큐브,050120,inf,-39.39,1672,1858,3530
391,HB솔루션,297890,inf,-6.01,1809,1722,3531
1435,에코캡,128540,inf,-18.21,1403,2130,3533
489,영신금속,007530,inf,-5.14,1756,1780,3536
417,대창솔루션,096350,inf,-48.93,1746,1793,3539
361,코아스,071950,inf,-6.81,1837,1704,3541
1175,파인텍,131760,inf,-57.81,1811,1731,3542
766,비디아이,148140,inf,-498.52,1766,1789,3555
1000,한국내화,010040,64.99,,1155,2403,3558
11,OCI,010060,inf,-9.89,1968,1591,3559
336,서원,021050,inf,-5.38,1787,1772,3559
1013,화승코퍼레이션,013520,inf,-17.15,1413,2146,3559
868,코스맥스엔비티,222040,inf,-18.89,1443,2124,3567
1191,하이소닉,106080,inf,-79.27,1931,1640,3571
532,지유온,111820,inf,-44.52,1765,1813,3578
687,케이탑리츠,145270,inf,-inf,2142,1445,3587
493,와이더플래닛,321820,inf,-inf,2146,1442,3588
1306,하이골드12호,172580,inf,-inf,2098,1491,3589
48,신한알파리츠,293940,inf,-inf,2099,1490,3589
638,맥쿼리인프라,088980,inf,-inf,2148,1441,3589
400,TS트릴리온,317240,inf,-13.73,1380,2210,3590
1483,지놈앤컴퍼니,314130,inf,-inf,2104,1489,3593
183,에코프로에이치엔,383310,inf,-inf,2155,1440,3595
658,센트럴인사이트,012600,inf,-53.41,1855,1742,3597
1383,바이오스마트,038460,inf,-8.64,1970,1627,3597
823,오리엔트정공,065500,inf,-45.98,1794,1805,3599
1779,케이피에스,256940,inf,-5.98,1847,1753,3600
742,덴티스,261200,inf,-43.01,1782,1820,3602
280,나눔테크,244880,inf,-inf,2140,1463,3603
644,베트남개발1,096300,inf,-inf,2145,1462,3607
1045,대한뉴팜,054670,inf,-16.8,1458,2151,3609
1644,경남제약,053950,inf,-9.26,2010,1603,3613
1403,소룩스,290690,inf,-inf,2129,1487,3616
35,모두투어리츠,204210,inf,-inf,2128,1488,3616
2304,삼기,122350,inf,-5.61,1850,1767,3617
768,삼영에스앤씨,361670,inf,-inf,2135,1486,3621
1425,에이디엠코리아,187660,inf,-inf,2137,1485,3622
1672,라온시큐어,042510,inf,-38.05,1757,1865,3622
1499,토박스코리아,215480,inf,-15.55,1450,2172,3622
2293,바른전자,064520,inf,-48.84,1828,1794,3622
281,다원넥스뷰,323350,inf,-inf,2139,1483,3622
2028,에코프로비엠,247540,75.69,,1219,2404,3623
1589,알루코,001780,inf,-7.24,1954,1673,3627
1370,라닉스,317120,inf,-13.08,1412,2219,3631
527,중앙디앤엠,051980,inf,-49.01,1844,1792,3636
317,대구백화점,006370,inf,-6.63,1927,1709,3636
1583,서울식품공업,004410,inf,-9.36,2036,1601,3637
574,한국코퍼레이션,050540,inf,-53.55,1896,1741,3637
1839,DL이앤씨,375500,inf,-inf,2201,1439,3640
550,크루셜텍,114120,inf,-38.2,1776,1864,3640
1561,대림통상,006570,inf,-15.14,1466,2178,3644
755,리더스 기술투자,019570,8.29,,1242,2405,3647
621,다스코,058730,inf,-6.54,1936,1711,3647
1452,우리넷,115440,inf,-17.71,1515,2136,3651
2436,힘스,238490,8.42,,1249,2406,3655
818,엔케이맥스,182400,inf,-36.46,1779,1877,3656
1031,글로벌텍스프리,204620,inf,-7.67,1997,1660,3657
2232,한창,005110,inf,-53.91,1919,1739,3658
1570,동양고속,084670,inf,-13.74,1453,2208,3661
440,멜파스,096640,inf,-38.87,1801,1862,3663
288,에스알바이오텍,270210,inf,-inf,2226,1438,3664
810,에이스침대,003800,8.57,,1257,2407,3664
520,전진바이오팜,110020,inf,-48.21,1870,1797,3667
842,이즈미디어,181340,inf,-66.13,1980,1688,3668
406,나이벡,138610,inf,-12.28,1433,2237,3670
1574,롯데쇼핑,023530,inf,-7.7,2012,1659,3671
513,이엔코퍼레이션,066980,inf,-50.7,1922,1750,3672
1182,퓨쳐켐,220100,inf,-84.72,2063,1611,3674
1449,와이제이엠게임즈,193250,inf,-11.87,1425,2249,3674
617,금호타이어,073240,inf,-6.74,1969,1707,3676
689,태평양물산,007980,inf,-7.13,1998,1678,3676
2182,상신브레이크,041650,inf,-1.59,1374,2304,3678
925,국보,001140,inf,-67.86,1994,1684,3678
1148,이엠앤아이,083470,inf,-72.69,2032,1649,3681
176,에스앤에스텍,101490,80.67,,1276,2408,3684
809,에이비엘바이오,298380,inf,-49.94,1894,1790,3684
614,YG PLUS,037270,inf,-6.94,1986,1701,3687
1493,코디,080530,inf,-9.18,2083,1606,3689
576,한일화학,007770,inf,-1.42,1378,2311,3689
246,트루윈,105550,83.02,,1281,2409,3690
1485,진시스템,363250,inf,-inf,2256,1437,3693
97,KH바텍,060720,inf,-7.58,2030,1663,3693
1253,비비안,002070,inf,-54.0,1956,1738,3694
1648,광진실업,026910,inf,-12.03,1455,2240,3695
2395,차바이오텍,085660,inf,-5.1,1915,1783,3698
1850,TCC스틸,002710,inf,-1.3,1382,2317,3699
800,안트로젠,065660,inf,-5.85,1945,1756,3701
1145,이브이첨단소재,131400,inf,-13.79,1495,2207,3702
1649,그린플러스,186230,inf,-5.53,1934,1769,3703
257,피델릭스,032580,inf,-14.08,1507,2197,3704
750,라이트론,069540,inf,-43.4,1886,1818,3704
1107,에스디생명공학,217480,inf,-10.04,1414,2290,3704
495,우리로,046970,inf,-34.37,1812,1893,3705
323,덕양산업,024900,inf,-12.7,1473,2233,3706
479,아이엠,101390,inf,-46.43,1906,1804,3710
938,두산,000150,inf,-34.34,1817,1894,3711
1140,위메이드맥스,101730,inf,-65.69,2024,1689,3713
137,미코바이오메드,214610,inf,-inf,2279,1435,3714
717,KG ETS,151860,9.08,,1304,2410,3714
295,큐엠씨,136660,inf,-inf,2278,1436,3714
2202,유엔젤,072130,inf,-1.67,1417,2301,3718
554,테라사이언스,073640,inf,-30.74,1804,1914,3718
394,NHN벅스,104200,inf,-5.78,1957,1762,3719
855,진바이오텍,086060,inf,-5.09,1933,1786,3719
370,한국전자홀딩스,006200,inf,-5.36,1946,1774,3720
129,딥노이드,315640,inf,-inf,2289,1434,3723
381,화승알앤에이,378850,inf,-inf,2291,1433,3724
729,나인테크,267320,inf,-6.43,2014,1713,3727
1275,에쓰씨엔지니어링,023960,inf,-5.06,1940,1787,3727
2216,진원생명과학,011000,inf,-30.43,1815,1917,3732
998,폴루스바이오팜,007630,inf,-7.07,2052,1682,3734
1661,동방선기,099410,inf,-3.3,1785,1949,3734
262,하이즈항공,221840,inf,-5.12,1952,1782,3734
1070,바른손이앤에이,035620,inf,-10.52,1457,2278,3735
45,세기상사,002420,inf,-7.13,2057,1679,3736
2312,세동,053060,inf,-82.78,2123,1614,3737
1125,엠피대산,065150,inf,-68.72,2054,1683,3737
1340,YBM넷,057030,inf,-3.91,1810,1928,3738
1254,비상교육,100220,inf,-7.23,2064,1674,3738
1098,아우딘퓨쳐스,227610,inf,-45.48,1930,1808,3738
1286,조일알미늄,018470,inf,-7.85,2084,1657,3741
1102,알에스오토메이션,140670,inf,-7.46,2077,1666,3743
622,다이나믹디자인,145210,inf,-90.21,2156,1588,3744
1386,본느,226340,inf,-5.79,1983,1761,3744
133,모비스,250060,inf,-5.79,1985,1760,3745
108,나노스,151910,inf,-4.75,1910,1836,3746
1456,유니크,011320,inf,-3.92,1820,1926,3746
917,LX하우시스,108670,inf,-8.8,2125,1621,3746
75,태양금속공업,004100,inf,-11.4,1490,2257,3747
296,티티씨디펜스,309900,inf,-inf,2316,1432,3748
1715,신라에스지,025870,inf,-9.05,2141,1608,3749
1660,데브시스터즈,194480,inf,-5.7,1988,1763,3751
2036,엘앤케이바이오,156100,inf,-40.29,1924,1827,3751
2410,텔레칩스,054450,inf,-9.63,2158,1596,3754
911,JW중외제약,001060,inf,-6.97,2059,1700,3759
2322,쏠리드,050890,inf,-9.87,2168,1593,3761
685,진도,088790,inf,-1.84,1467,2294,3761
1759,윈텍,320000,inf,-9.35,2159,1602,3761
1044,대원,007680,inf,-3.71,1829,1934,3763
2406,퀀타매트릭스,317690,inf,-33.82,1866,1898,3764
1737,에코마이스터,064510,inf,-385.76,1903,1861,3764
1397,서울제약,018680,inf,-4.68,1929,1839,3768
1380,모베이스,101330,inf,-4.88,1937,1832,3769
874,텔콘RF제약,200230,inf,-41.93,1948,1822,3770
710,현대퓨처넷,126560,inf,-4.11,1925,1846,3771
1379,메카로,241770,inf,-1.18,1449,2323,3772
726,국전약품,307750,inf,-inf,2344,1431,3775
107,나노브릭,286750,inf,-0.65,1429,2348,3777
616,금양,001570,inf,-5.36,2006,1773,3779
740,더블유에스아이,299170,inf,-inf,2349,1430,3779
641,미래에셋맵스리츠,357250,inf,-inf,2351,1428,3779
506,유안타제8호스팩,367480,inf,-inf,2350,1429,3779
2398,캔서롭,180400,inf,-25.54,1777,2003,3780
104,국일제지,078130,inf,-0.84,1441,2341,3782
1586,세종공업,033530,inf,-4.69,1944,1838,3782
271,한화플러스제2호스팩,386580,inf,-inf,2356,1427,3783
1392,삼천당제약,000250,inf,-0.56,1438,2350,3788
519,잉크테크,049550,inf,-1.51,1482,2308,3790
1752,웨이브일렉트로,095270,inf,-273.02,1813,1978,3791
2433,한스바이오메드,042520,inf,-26.39,1798,1995,3793
236,케이피티유,054410,inf,-10.11,1506,2288,3794
1572,동원수산,030720,inf,-6.53,2082,1712,3794
151,스타모빌리티,158310,inf,-inf,2355,1443,3798
227,주성엔지니어링,036930,inf,-3.52,1858,1941,3799
1653,네패스,033640,inf,-23.33,1775,2024,3799
1151,제너셈,217190,inf,-6.32,2085,1715,3800
2220,카프로,006380,inf,-39.82,1947,1854,3801
270,한화플러스제1호스팩,340440,inf,-inf,2358,1444,3802
1480,조광ILI,044060,inf,-5.64,2038,1764,3802
1090,시그네틱스,033170,inf,-30.75,1891,1913,3804
923,경인양행,012610,inf,-4.18,1960,1845,3805
1953,기가레인,049080,inf,-65.46,2114,1691,3805
762,베셀,177350,inf,-5.25,2031,1777,3808
1712,수젠텍,253840,inf,-93.85,2223,1585,3808
86,현대건설기계,267270,inf,-0.8,1468,2342,3810
1662,동우팜투테이블,088910,inf,-1.25,1493,2319,3812
1633,화천기계,010660,inf,-3.72,1881,1932,3813
380,호텔신라,008770,inf,-36.74,1938,1875,3813
951,부산주공,005030,inf,-47.39,2015,1800,3815
166,아이오케이,078860,inf,-4.04,1964,1852,3816
2289,마이크로디지탈,305090,inf,-82.28,2200,1616,3816
1265,성안,011300,inf,-36.36,1939,1878,3817
977,용평리조트,070960,inf,-4.54,1977,1840,3817
1216,AK홀딩스,006840,inf,-20.57,1767,2051,3818
2021,에스제이케이,080440,inf,-82.93,2208,1613,3821
1177,펩트론,087010,inf,-34.94,1935,1888,3823
82,한일철강,002220,inf,-3.3,1874,1950,3824
802,알티캐스트,085810,inf,-5.83,2067,1758,3825
1011,현대일렉트릭,267260,inf,-5.84,2070,1757,3827
1104,알파홀딩스,117670,inf,-5.62,2062,1766,3828
145,선진뷰티사이언스,086710,inf,-inf,2382,1446,3828
1946,OQP,078590,inf,-260.78,1842,1987,3829
1292,코오롱머티리얼,144620,inf,-21.4,1790,2040,3830
386,효성화학,298000,inf,-2.71,1759,2071,3830
1666,드림어스컴퍼니,060570,inf,-21.59,1793,2038,3831
1784,코아시아옵틱스,196450,inf,-26.49,1841,1993,3834
341,솔루스첨단소재,336370,inf,-5.1,2051,1784,3835
700,한국주강,025890,inf,-4.28,1993,1843,3836
841,이수앱지스,086890,inf,-40.23,2007,1829,3836
2246,CNT85,056730,inf,-74.04,2189,1647,3836
2382,인피니티엔티,016670,inf,-77.1,2193,1644,3837
1486,카스,016920,inf,-5.09,2053,1785,3838
1559,금비,008870,inf,-3.4,1895,1944,3839
1366,동양파일,228340,inf,-5.55,2072,1768,3840
549,큐브엔터,182360,inf,-0.75,1498,2344,3842
261,하나기술,299030,inf,-inf,2384,1460,3844
512,이삭엔지니어링,351330,inf,-inf,2383,1461,3844
293,이도바이오,336040,inf,-inf,2386,1459,3845
279,관악산업,076340,inf,-inf,2388,1458,3846
143,샘씨엔에스,252990,inf,-inf,2389,1457,3846
1465,이엠코리아,095190,inf,-3.04,1889,1958,3847
967,신세계,004170,inf,-2.81,1783,2066,3849
102,교보9호스팩,331520,inf,-0.5,1496,2355,3851
141,삼성스팩4호,377630,inf,-inf,2396,1455,3851
294,진코스텍,250030,inf,-inf,2395,1456,3851
387,APS홀딩스,054620,inf,-24.63,1843,2010,3853
1032,글로본,019660,inf,-26.55,1861,1992,3853
305,LX홀딩스,383800,inf,-inf,2401,1453,3854
292,이노진,344860,inf,-inf,2400,1454,3854
1396,서울옥션,063170,inf,-4.06,2004,1850,3854
2299,블루베리 NFT,044480,inf,-58.75,2126,1729,3855
718,NEW,160550,inf,-5.14,2078,1779,3857
2189,아시아나항공,020560,inf,-43.83,2043,1815,3858
2078,지더블유바이텍,036180,inf,-53.74,2119,1740,3859
291,유투바이오,221800,inf,-inf,2407,1452,3859
354,이스타코,015020,inf,-0.12,1491,2368,3859
1106,앤씨앤,092600,inf,-45.91,2056,1807,3863
290,엘리비젼,276240,inf,-inf,2414,1450,3864
811,에이치피오,357230,inf,-inf,2413,1451,3864
1061,메드팩토,235980,inf,-37.72,1996,1869,3865
2092,코센,009730,inf,-208.76,1821,2045,3866
289,에이스캠퍼,322190,inf,-inf,2417,1449,3866
487,엠에프엠코리아,323230,inf,-inf,2418,1448,3866
1786,큐로컴,040350,inf,-21.77,1831,2036,3867
1914,티웨이홀딩스,004870,inf,-71.98,2219,1650,3869
2069,일야,058450,inf,-67.43,2183,1686,3869
385,효성,004800,inf,-2.26,1780,2090,3870
1300,태원물산,001420,inf,-0.08,1504,2369,3873
2005,씨유메디칼,115480,inf,-55.78,2143,1733,3876
1981,명성티엔에스,257370,inf,-30.08,1955,1922,3877
2249,KH E&T,226360,inf,-59.52,2157,1725,3882
60,이월드,084680,inf,-4.11,2037,1847,3884
1903,인바이오젠,101140,inf,-62.65,2188,1697,3885
551,크리스탈지노믹스,083790,inf,-5.41,2115,1770,3885
1170,태광,023160,inf,-1.18,1564,2322,3886
1039,넥스트BT,065170,inf,-32.18,1978,1908,3886
330,백산,035150,inf,-11.97,1641,2246,3887
524,제일제강,023440,inf,-7.12,2207,1680,3887
428,레이언스,228850,inf,-1.0,1557,2330,3887
777,소리바다,053110,inf,-394.31,2034,1853,3887
1579,삼성중공업,010140,inf,-33.05,1984,1904,3888
1260,삼일씨엔에스,004440,inf,-0.37,1530,2358,3888
2250,KH 일렉트론,111870,inf,-39.46,2033,1857,3890
2411,텔레필드,091440,inf,-28.63,1920,1974,3894
444,바이오로그디바이스,208710,inf,-36.03,2013,1882,3895
2403,코오롱티슈진,950160,inf,-59.61,2172,1724,3896
2340,에스와이,109610,inf,-19.13,1778,2119,3897
1787,큐리언트,115180,inf,-52.68,2153,1744,3897
2231,한진칼,180640,inf,-19.55,1786,2112,3898
2255,THE E&M,089230,inf,-30.03,1976,1923,3899
1229,S-Oil,010950,inf,-13.07,1679,2220,3899
876,티라유텍,322180,inf,-3.97,1974,1925,3899
1020,KD,044180,inf,-17.43,1758,2143,3901
2045,우정바이오,215380,inf,-39.78,2046,1855,3901
2071,제넨바이오,072520,inf,-58.12,2173,1730,3903
1153,제로투세븐,159580,inf,-0.85,1566,2338,3904
2158,넥스트사이언스,003580,inf,-41.41,2079,1825,3904
229,지엔코,065060,inf,-23.2,1879,2025,3904
1898,와이투솔루션,011690,inf,-64.02,2211,1694,3905
910,GKL,114090,inf,-12.01,1665,2241,3906
404,국영지앤엠,006050,inf,-2.51,1825,2081,3906
1793,티에스아이,277880,inf,-5.28,2131,1776,3907
875,토비스,051360,inf,-3.39,1962,1945,3907
177,에스에너지,095910,inf,-20.55,1856,2052,3908
1909,지코,010580,inf,-63.51,2214,1695,3909
1355,노랑풍선,104620,inf,-11.18,1648,2262,3910
1460,유틸렉스,263050,inf,-47.42,2112,1799,3911
865,케이피에프,024880,inf,-3.83,1982,1929,3911
1406,스카이문스테크놀로지,033790,inf,-4.23,2068,1844,3912
507,육일씨엔에쓰,191410,inf,-81.21,2297,1617,3914
1250,벽산,007210,inf,-0.67,1569,2346,3915
505,유바이오로직스,206650,inf,-91.23,2328,1587,3915
2308,서남,294630,inf,-50.26,2167,1751,3918
525,젬백스지오,041590,inf,-0.42,1561,2357,3918
171,알에프텍,061040,inf,-21.17,1877,2042,3919
2024,에이치엘비제약,047920,inf,-239.39,1900,2019,3919
796,아스타,246720,inf,-96.87,2337,1582,3919
1473,자안코스메틱,219550,inf,-44.66,2111,1811,3922
1327,GV,045890,inf,-43.72,2105,1817,3922
2029,에프앤리퍼블릭,064090,inf,-212.79,1890,2033,3923
579,형지I&C,011080,inf,-35.22,2039,1885,3924
1578,부광약품,003000,inf,-2.46,1840,2086,3926
2309,서울리거,043710,inf,-63.28,2232,1696,3928
134,모트렉스,118990,inf,-17.48,1791,2141,3932
1363,대호특수강,021040,inf,-43.03,2113,1819,3932
2271,다믈멀티미디어,093640,inf,-4.99,2103,1830,3933
973,엔케이,085310,inf,-0.03,1563,2371,3934
1038,넥스턴바이오,089140,inf,-2.47,1852,2085,3937
854,좋은사람들,033340,inf,-30.15,2018,1920,3938
2032,엔에스엔,031860,inf,-38.34,2076,1863,3939
955,삼성제약,001360,inf,-30.13,2019,1921,3940
360,코스모화학,005420,inf,-19.42,1826,2115,3941
1796,파루,043200,inf,-65.0,2249,1693,3942
2372,이노메트리,302430,inf,-7.44,2275,1667,3942
1568,동성제약,002210,inf,-22.52,1912,2030,3942
1776,체리부로,066360,inf,-60.62,2243,1699,3942
2148,LS네트웍스,000680,inf,-4.87,2110,1833,3943
1963,대보마그네틱,290670,inf,-2.95,1882,2061,3943
1402,셀리버리,268600,inf,-52.52,2197,1746,3943
2206,이화산업,000760,inf,-2.65,1872,2073,3945
942,롯데관광개발,032350,inf,-30.43,2027,1918,3945
109,네오리진,094860,inf,-17.65,1808,2138,3946
92,EDGC,245620,inf,-19.0,1824,2123,3947
1518,현대에버다임,041440,inf,-3.81,2017,1930,3947
1803,피피아이,062970,inf,-25.02,1942,2006,3948
65,자화전자,033240,inf,-2.3,1863,2089,3952
1975,디젠스,113810,inf,-37.46,2081,1871,3952
1322,CJ프레시웨이,051500,inf,-20.16,1893,2060,3953
839,이더블유케이,258610,inf,-20.49,1898,2055,3953
188,엔투텍,227950,inf,-67.56,2269,1685,3954
1732,에스코넥,096630,inf,-59.88,2234,1723,3957
1368,디이엔티,079810,inf,-44.87,2149,1810,3959
1012,현대제철,004020,inf,-2.59,1885,2075,3960
1390,삼보산업,009620,inf,-39.36,2101,1859,3960
2156,금호에이치티,214330,inf,-4.85,2127,1834,3961
125,디엔에이링크,127120,inf,-54.03,2225,1737,3962
451,삼일,032280,inf,-5.03,2175,1788,3963
2381,인터플렉스,051370,inf,-22.49,1932,2031,3963
2019,에스디시스템,121890,inf,-34.16,2069,1895,3964
346,아이에이치큐,003560,inf,-14.32,1771,2194,3965
1781,코리아에스이,101670,inf,-15.76,1795,2170,3965
1789,태웅,044490,inf,-18.21,1836,2129,3965
2017,애머릿지,900100,inf,-34.47,2073,1892,3965
537,케이엔더블유,105330,inf,-25.59,1965,2002,3967
90,호전실업,111110,inf,-14.99,1784,2183,3967
2098,팬젠,222110,inf,-26.69,1979,1990,3969
2256,THE MIDONG,161570,inf,-29.66,2003,1966,3969
2042,우리기술,032820,inf,-2.94,1908,2062,3970
2328,아스트,067390,inf,-18.02,1838,2132,3970
933,대원강업,000430,inf,-1.36,1656,2315,3971
78,하이트론씨스템즈,019490,inf,-136.89,1773,2199,3972
1937,효성중공업,298040,inf,-2.48,1888,2084,3972
894,헬릭스미스,084990,inf,-35.12,2087,1886,3973
1183,프리시젼바이오,335810,inf,-20.41,1918,2056,3974
315,남성,004270,inf,-19.75,1864,2110,3974
1772,제이엠아이,033050,inf,-20.63,1926,2049,3975
1927,한익스프레스,014130,inf,-2.87,1911,2064,3975
906,AJ네트웍스,095570,inf,-1.3,1659,2316,3975
50,쌍용자동차,003620,inf,-320.22,2071,1905,3976
1916,평화홀딩스,010770,inf,-2.68,1904,2072,3976
1348,나무기술,242040,inf,-19.57,1865,2111,3976
2248,ITX-AI,099520,inf,-21.92,1941,2035,3976
1318,형지엘리트,093240,inf,-2.02,1873,2103,3976
488,연이비앤티,090740,inf,-168.44,1833,2148,3981
1118,엔에이치스팩13호,310840,inf,-0.06,1612,2370,3982
995,토니모리,214420,inf,-46.89,2182,1801,3983
357,일동홀딩스,000230,inf,-14.74,1796,2187,3983
1438,엑사이엔씨,054940,inf,-1.38,1671,2313,3984
432,릭스솔루션,029480,inf,-82.72,2371,1615,3986
1799,팬스타엔터프라이즈,054300,inf,-16.59,1834,2153,3987
859,캐리소프트,317530,inf,-27.56,2005,1982,3987
2373,이노테라피,246960,inf,-21.75,1951,2037,3988
1765,이큐셀,160600,inf,-205.56,1943,2046,3989
1276,에어부산,298690,inf,,1578,2411,3989
132,매직마이크로,127160,inf,-128.87,1769,2221,3990
634,디와이,013570,inf,-3.39,2044,1946,3990
671,에이프로젠 MED,007460,inf,-15.79,1822,2169,3991
1194,한송네오텍,226440,inf,,1579,2412,3991
2282,드래곤플라이,030350,inf,-84.16,2379,1612,3991
1973,디에스케이,109740,inf,-14.54,1802,2190,3992
1199,휴럼,353190,inf,,1580,2413,3993
2072,제노포커스,187420,inf,-26.59,2002,1991,3993
2064,인터엠,017250,inf,-32.68,2086,1907,3993
764,부방,014470,inf,-3.33,2047,1947,3994
2107,한국정밀기계,101680,inf,-25.9,1995,1999,3994
607,SG글로벌,001380,inf,-1.79,1699,2295,3994
1669,디케이락,105740,inf,,1581,2414,3995
2050,웹스,196700,inf,-2.21,1901,2095,3996
1971,동일철강,023790,inf,-15.66,1827,2171,3998
1683,미래에셋대우스팩 5호,353490,inf,,1583,2415,3998
1695,비츠로시스,054220,inf,,1584,2416,4000
238,코스나인,082660,inf,,1585,2417,4002
2209,일진디스플,020760,inf,-94.15,2420,1584,4004
2033,엔에이치스팩17호,359090,inf,,1586,2418,4004
95,JW신약,067290,inf,-10.51,1726,2279,4005
1985,바이오솔루션,086820,inf,,1587,2419,4006
2000,소프트센,032680,inf,,1588,2420,4008
1358,뉴지랩파마,214870,inf,-35.01,2122,1887,4009
618,넥센타이어,002350,inf,-1.08,1684,2326,4010
794,아모센스,357580,,-98.75,2429,1581,4010
2057,이노와이즈,086250,inf,,1589,2421,4010
1703,서부T&D,006730,inf,,1590,2422,4012
1735,에이치엠씨제4호스팩,353070,inf,,1591,2423,4014
1994,서진시스템,178320,inf,-2.18,1917,2098,4015
2323,씨아이에스,222080,inf,-7.73,2357,1658,4015
393,IBKS제14호스팩,351320,inf,,1592,2424,4016
397,RF머트리얼즈,327260,inf,,1593,2425,4018
23,대덕전자,353200,inf,,1594,2426,4020
2109,한빛소프트,047080,inf,-12.71,1789,2231,4020
857,초록뱀미디어,047820,inf,-28.82,2049,1971,4020
1281,웰바이오텍,010600,inf,-141.53,1839,2182,4021
187,엔에이치스팩18호,365590,inf,,1595,2427,4022
883,퓨쳐스트림네트웍스,214270,inf,-10.5,1742,2280,4022
1679,메지온,140410,inf,-27.76,2041,1981,4022
1844,SG세계물산,004060,inf,-5.16,2246,1778,4024
206,유안타제7호스팩,367460,inf,,1596,2428,4024
1008,한진중공업홀딩스,003480,inf,-1.15,1702,2324,4026
210,이베스트스팩5호,349720,inf,,1597,2429,4026
2330,아이텍,119830,inf,-8.15,2391,1636,4027
12,SK이노베이션,096770,inf,-13.58,1814,2213,4027
1719,씨씨에스,066790,inf,-11.55,1772,2255,4027
557,파수,150900,inf,-3.7,2093,1935,4028
2384,자연과환경,043910,inf,-15.1,1849,2179,4028
655,성보화학,003080,inf,,1598,2430,4028
806,에스트래픽,234300,inf,-71.07,2376,1653,4029
2047,원풍물산,008290,inf,-20.24,1972,2058,4030
739,대한광통신,010170,inf,-16.51,1876,2154,4030
1095,씨티씨바이오,060590,inf,-25.76,2029,2001,4030
497,우림기계,101170,inf,,1599,2431,4030
943,롯데칠성음료,005300,inf,-1.0,1701,2329,4030
2379,인바이오,352940,inf,-13.64,1819,2212,4031
437,메디프론,065650,inf,,1600,2432,4032
548,큐브앤컴퍼니,043090,inf,,1601,2433,4034
2346,에이치엘비생명과학,067630,inf,-17.97,1902,2134,4036
2073,제닉,123330,inf,-17.6,1897,2139,4036
2179,비케이탑스,030790,inf,,1602,2434,4036
231,캐스텍코리아,071850,inf,-16.44,1880,2157,4037
2261,교보10호기업인수목적,355150,inf,,1603,2435,4038
798,아진산업,013310,inf,-0.66,1691,2347,4038
714,JTC,950170,inf,-57.43,2307,1732,4039
240,코오롱생명과학,102940,inf,,1604,2436,4040
1108,에스씨엠생명과학,298060,inf,-24.1,2026,2016,4042
1461,이미지스,115610,inf,-45.43,2233,1809,4042
1469,이화전기,024810,inf,,1606,2437,4043
769,삼진엘앤디,054090,inf,-1.67,1743,2300,4043
961,세아특수강,019440,inf,-1.42,1731,2312,4043
2265,네온테크,306620,inf,-21.1,2001,2043,4044
1357,뉴보텍,060260,inf,,1607,2438,4045
1733,에스티오,098660,inf,-8.24,2410,1635,4045
960,서연,007860,inf,-1.26,1727,2318,4045
1444,오르비텍,046120,inf,-36.54,2170,1876,4046
461,성우하이텍,015750,inf,-4.93,2215,1831,4046
603,KC코트렐,119650,inf,-148.07,1867,2180,4047
2360,오스코텍,039200,inf,-8.35,2416,1633,4049
661,신도리코,029530,inf,-1.56,1745,2306,4051
2348,에이트원,230980,inf,-4.05,2202,1851,4053
888,하나금융16호스팩,343510,inf,-0.7,1710,2345,4055
1774,지엔원에너지,270520,inf,-14.89,1871,2184,4055
713,IBKS제12호스팩,335870,inf,-0.52,1703,2353,4056
2286,로보티즈,108490,inf,-0.22,1693,2363,4056
533,지티지웰니스,219750,inf,-135.68,1857,2200,4057
1360,대신밸런스제9호스팩,369370,inf,,1620,2439,4059
694,하이스틸,071090,inf,-0.99,1728,2332,4060
51,쎌마테라퓨틱스,015540,inf,-1165.4,1818,2242,4060
543,코미팜,041960,inf,-3.77,2130,1931,4061
208,유테크,178780,inf,-37.46,2190,1872,4062
1619,한국화장품,123690,inf,-23.66,2045,2022,4067
521,정다운,208140,inf,-4.09,2220,1848,4068
1795,티움바이오,321550,inf,,1628,2440,4068
311,금강공업,014280,inf,-0.55,1717,2351,4068
931,대림비앤코,005750,inf,-1.05,1741,2327,4068
2390,제테마,216080,inf,-24.71,2061,2009,4070
1639,DB금융스팩8호,367340,inf,,1629,2441,4070
485,에스티팜,237690,inf,-4.08,2222,1849,4071
1001,한국철강,104700,inf,-1.19,1750,2321,4071
1641,IBKS제13호스팩,351340,inf,,1630,2442,4072
1042,대신밸런스제7호스팩,332290,inf,-0.21,1708,2364,4072
2422,플리토,300080,inf,-20.6,2023,2050,4073
79,한국공항,005430,inf,-15.94,1907,2166,4073
1780,케이피엠테크,042040,inf,-7.4,2405,1669,4074
1597,인디에프,014990,inf,-41.73,2251,1823,4074
1374,리메드,302550,inf,,1631,2443,4074
932,대양금속,009190,inf,-0.91,1740,2334,4074
2408,클라우드에어,036170,inf,-13.4,1862,2214,4076
1041,대성엘텍,025440,inf,-1.05,1748,2328,4076
1371,라온피플,300120,inf,,1632,2444,4076
1612,콤텍시스템,031820,inf,,1633,2445,4078
2314,소마젠,950200,inf,-235.28,2060,2020,4080
2210,잇츠한불,226320,inf,-3.52,2138,1942,4080
2016,압타머사이언스,291650,inf,-18.25,1958,2127,4085
1738,에프엔씨엔터,173940,inf,-12.16,1848,2238,4086
272,해성옵틱스,076610,inf,-124.13,1859,2227,4086
2085,케이엔제이,272110,inf,-20.41,2035,2057,4092
776,세코닉스,053450,inf,-30.54,2177,1916,4093
816,엔지스테크널러지,208860,inf,-33.41,2192,1901,4093
606,SBS미디어홀딩스,101060,inf,-11.93,1845,2248,4093
490,예림당,036000,inf,-27.15,2116,1986,4102
555,테라젠이텍스,066700,inf,-3.52,2162,1940,4102
2056,유진로봇,056080,inf,-22.55,2075,2029,4104
2080,지엘팜텍,204840,inf,-40.26,2276,1828,4104
127,디자인,227100,inf,-195.85,2000,2107,4107
2316,쇼박스,086980,inf,-1.91,1816,2292,4108
1373,로스웰,900260,inf,-34.55,2218,1891,4109
896,휴먼엔,032860,inf,-291.98,2147,1962,4109
1894,에이엔피,015260,inf,-50.96,2367,1749,4116
1382,바이오다인,314930,,-65.61,2428,1690,4118
2011,아이에스이커머스,069920,inf,-20.91,2074,2047,4121
2197,예스코홀딩스,015360,inf,-13.18,1905,2217,4122
2311,성우전자,081580,inf,-3.58,2184,1939,4123
2326,아난티,025980,inf,-10.96,1853,2272,4125
1721,아리온,058220,inf,-586.75,2399,1727,4126
1860,대교,019680,inf,-3.02,2171,1960,4131
1769,일지테크,019540,inf,-11.16,1869,2263,4132
2104,하이텍팜,106190,inf,-3.25,2181,1952,4133
1899,웅진,016880,inf,-39.32,2274,1860,4134
808,에이디칩스,054630,inf,-28.5,2161,1976,4137
1075,비보존 헬스케어,082800,inf,-40.36,2312,1826,4138
1896,영흥,012160,inf,-12.89,1909,2230,4139
2402,코리아나,027050,inf,-0.63,1792,2349,4141
2387,제이스텍,090470,inf,-11.6,1887,2254,4141
2413,티케이케미칼,104480,inf,-0.5,1788,2354,4142
56,오리엔트바이오,002630,inf,-29.7,2179,1965,4144
1783,코아스템,166480,inf,-46.85,2343,1802,4145
2391,지노믹트리,228760,inf,-11.55,1892,2256,4148
2188,아센디오,012170,inf,-124.63,1923,2226,4149
158,썸에이지,208640,inf,-31.25,2240,1911,4151
223,제이엘케이,322510,inf,-22.81,2124,2027,4151
390,CSA 코스믹,083660,inf,-103.35,1883,2269,4152
1651,나노씨엠에스,247660,,-59.31,2427,1726,4153
2010,아이앤씨,052860,inf,-11.95,1913,2247,4160
429,로보로보,215100,inf,-12.7,1928,2232,4160
274,현대바이오,048410,inf,-17.53,2021,2140,4161
181,에이스토리,241840,inf,-21.3,2120,2041,4161
990,진에어,272450,inf,-131.35,1961,2203,4164
2162,대우부품,009320,inf,-10.09,1875,2289,4164
355,이엔플러스,074610,inf,-27.8,2186,1979,4165
1884,삼화전자공업,011230,inf,-19.35,2050,2116,4166
1164,코텍,052330,inf,-2.76,2096,2070,4166
2023,에스티큐브,052020,inf,-49.2,2380,1791,4171
941,디아이씨,092200,inf,-128.28,1949,2222,4171
1749,우리이앤엘,153490,inf,-2.52,2095,2078,4173
165,아이씨케이,068940,inf,-20.54,2121,2053,4174
2190,에스케이바이오팜,326030,inf,-135.18,1973,2201,4174
1546,KC그린홀딩스,009440,inf,-22.98,2152,2026,4178
724,골드앤에스,035290,inf,-27.37,2196,1983,4179
2362,올릭스,226950,inf,-44.52,2368,1812,4180
1713,스맥,099440,inf,-34.92,2293,1889,4182
679,일정실업,008500,inf,-15.33,2008,2175,4183
313,금호전기,001210,inf,-100.97,1916,2271,4187
2020,에스엠,041510,inf,-16.02,2025,2164,4189
155,시티랩스,139050,inf,-26.15,2194,1997,4191
2352,엔피케이,048830,inf,-1.54,1884,2307,4191
2305,삼영이엔씨,065570,inf,-3.25,2239,1953,4192
2349,에치에프알,230240,inf,-35.73,2309,1884,4193
2240,화신,010690,inf,-19.53,2080,2113,4193
1455,유니슨,018000,inf,-31.87,2284,1910,4194
2077,지나인제약,078650,inf,-126.69,1971,2223,4194
308,SPC삼립,005610,inf,-3.98,2271,1924,4195
2065,인트로메딕,150840,inf,-37.67,2327,1870,4197
1757,위지윅스튜디오,299900,inf,-2.24,2107,2092,4199
1716,신영스팩5호,323280,inf,-0.17,1835,2365,4200
160,씨케이에이치,900120,inf,-24.58,2191,2011,4202
2243,흥아해운,003280,inf,-379.56,2338,1866,4204
804,앱클론,174900,inf,-19.92,2097,2108,4205
1849,SUN&L,002820,inf,-4.32,2365,1842,4207
1515,한탑,002680,inf,-32.96,2301,1906,4207
152,스튜디오산타클로스,204630,inf,-25.53,2204,2004,4208
1771,제이에스티나,026040,inf,-36.2,2329,1880,4209
1272,신원,009270,inf,-3.91,2282,1927,4209
1081,서울전자통신,027040,inf,-3.31,2261,1948,4209
1171,티로보틱스,117730,inf,-3.45,2267,1943,4210
156,신영스팩6호,344050,inf,-2.0,2106,2105,4211
758,메디콕스,054180,inf,-29.06,2242,1970,4212
161,아나패스,123860,inf,-132.58,2016,2202,4218
2,GS글로벌,001250,inf,-24.91,2213,2007,4220
666,씨아이테크,004920,inf,-14.34,2028,2193,4221
2067,인포마크,175140,inf,-125.85,1999,2225,4224
2172,롯데지주,004990,inf,-3.03,2265,1959,4224
534,참좋은여행,094850,inf,-2.2,2133,2096,4229
4,KEC,092220,inf,-24.43,2217,2013,4230
1837,CJ CGV,079160,inf,-314.44,2322,1909,4231
2114,휘닉스소재,050090,inf,-15.87,2065,2167,4232
1725,안국약품,001540,inf,-0.9,1899,2335,4234
2212,제주항공,089590,inf,-113.11,1991,2244,4235
795,아비코전자,036010,inf,-2.64,2166,2074,4240
1957,네오펙트,290660,inf,-108.55,1975,2267,4242
54,영화금속,012280,inf,-12.53,2011,2234,4245
1762,이그잭스,060230,inf,-2.25,2154,2091,4245
430,루트로닉,085370,inf,-14.56,2058,2189,4247
582,휴센텍,215090,inf,-16.43,2089,2158,4247
2257,TJ미디어,032540,inf,-3.16,2294,1954,4248
2294,백금T&A,046310,inf,-13.73,2040,2209,4249
1815,휴비츠,065510,inf,-3.27,2299,1951,4250
1491,코너스톤네트웍스,033110,inf,-199.01,2144,2106,4250
112,네이처셀,007390,inf,-26.1,2252,1998,4250
844,인성정보,033230,inf,-16.13,2088,2163,4251
180,에이루트,096690,inf,-23.53,2230,2023,4253
1074,베노홀딩스,206400,inf,-30.62,2339,1915,4254
358,지엠비코리아,013870,inf,-3.69,2318,1936,4254
462,세경하이테크,148150,inf,-2.77,2185,2069,4254
801,알체라,347860,inf,-19.02,2134,2122,4256
1943,KPX생명과학,114450,inf,-1.77,1963,2297,4260
256,프로스테믹스,203690,inf,-29.16,2292,1968,4260
2370,유앤아이,056090,inf,-37.75,2392,1868,4260
1876,무림P&P,009580,inf,-1.43,1950,2310,4260
58,윌비스,008600,inf,-2.43,2174,2087,4261
168,아이큐어,175250,inf,-12.03,2022,2239,4261
1427,에이씨티,138360,inf,-19.46,2150,2114,4264
1810,해성티피씨,059270,,-4.47,2426,1841,4267
803,애니젠,196300,inf,-18.08,2136,2131,4267
1911,컨버즈,109070,inf,-367.38,2393,1874,4267
248,티앤알바이오팹,246710,inf,-15.83,2102,2168,4270
302,KR모터스,000040,inf,-29.64,2304,1967,4271
498,우수AMS,066590,inf,-10.33,1990,2283,4273
1180,폴라리스웍스,123010,inf,-24.02,2255,2018,4273
1073,바이온,032980,inf,-17.45,2132,2142,4274
1647,골드퍼시픽,038530,inf,-3.71,2341,1933,4274
1412,싸이토젠,217330,inf,-26.97,2288,1988,4276
2094,탑엔지니어링,065130,inf,-1.92,1989,2291,4280
2001,신진에스엠,138070,inf,-1.61,1981,2303,4284
1309,한세엠케이,069640,inf,-25.79,2286,2000,4286
824,오스테오닉,226400,inf,-20.21,2227,2059,4286
1632,화인베스틸,133820,inf,-18.43,2163,2125,4288
1364,대화제약,067080,inf,-2.49,2206,2082,4288
162,아이비김영,339950,inf,-2.51,2210,2079,4289
2318,신라젠,215600,inf,-114.04,2048,2243,4291
744,동신건설,025950,inf,-2.24,2199,2094,4293
1413,씨엔플러스,115530,inf,-21.96,2260,2034,4294
1726,알테오젠,196170,inf,-0.96,1966,2333,4299
456,삼화네트웍스,046390,inf,-2.86,2236,2065,4301
1494,큐로홀딩스,051780,inf,-34.14,2406,1896,4302
1731,에스엠코어,007820,inf,-0.9,1967,2336,4303
1027,감성코퍼레이션,036620,inf,-25.12,2300,2005,4305
2245,AP위성,211270,inf,-1.68,2009,2299,4308
237,켄코아에어로스페이스,274090,inf,-26.34,2313,1996,4309
494,와이지-원,019210,inf,-11.33,2055,2259,4314
741,덕신하우징,090410,inf,-10.92,2042,2273,4315
1948,SG,255220,inf,-1.09,1992,2325,4317
423,디알텍,214680,inf,-20.52,2264,2054,4318
1999,성광벤드,014620,inf,-0.32,1959,2360,4319
2236,현대미포조선,010620,inf,-0.84,1987,2340,4327
1484,지트리비앤티,115450,inf,-22.05,2295,2032,4327
1389,삼보모터스,053700,inf,-3.12,2373,1955,4328
1078,새로닉스,042600,inf,-2.2,2231,2097,4328
1595,이수페타시스,007660,inf,-19.14,2212,2118,4330
216,인베니아,079950,inf,-11.09,2066,2264,4330
1710,셀레믹스,331920,inf,-27.31,2346,1985,4331
831,위메이드,112040,inf,-3.0,2370,1961,4331
242,크로바하이텍,043590,inf,-24.46,2320,2012,4332
531,지란지교시큐리티,208350,inf,-3.04,2375,1957,4332
575,한일단조,024740,inf,-3.12,2378,1956,4334
1886,성문전자,014910,inf,-3.63,2398,1938,4336
1874,롯데손해보험,000400,inf,-2.53,2259,2077,4336
1416,아이톡시,052770,inf,-24.03,2321,2017,4338
866,코디엠,224060,inf,-18.0,2205,2133,4338
1430,에이치엘비,028300,inf,-24.1,2326,2015,4341
1420,알서포트,131370,inf,-2.08,2241,2101,4342
1150,자안바이오,221610,inf,-29.87,2385,1964,4349
1062,메디톡스,086900,inf,-11.82,2100,2250,4350
1301,티에이치엔,019180,inf,-24.87,2342,2008,4350
1596,이아이디,093230,inf,-15.35,2180,2174,4354
882,판타지오,032800,inf,-11.71,2109,2252,4361
1640,EMW,079190,inf,-20.72,2315,2048,4363
860,캠시스,050110,inf,-13.99,2160,2204,4364
1099,아이엘사이언스,307180,inf,,1921,2446,4367
1057,루멘스,038060,inf,-16.41,2209,2160,4369
1381,모아텍,033200,inf,-2.03,2268,2102,4370
849,재영솔루텍,049630,inf,-13.89,2165,2205,4370
1346,광림,014200,inf,-28.57,2397,1975,4372
2175,미래산업,025560,inf,-10.31,2090,2284,4374
1387,브릿지바이오,288330,inf,-28.65,2403,1973,4376
1463,이에스에이,052190,inf,-27.34,2394,1984,4378
1174,파인디앤씨,049120,inf,-28.66,2408,1972,4380
251,파워로직스,047310,inf,-11.02,2117,2265,4382
1610,코스맥스비티아이,044820,inf,-2.15,2283,2099,4382
1304,평화산업,090080,inf,-26.4,2390,1994,4384
817,엔지켐생명과학,183490,inf,-23.9,2366,2021,4387
971,에넥스,011090,inf,-17.89,2253,2135,4388
2264,네오이뮨텍,950220,,-29.94,2425,1963,4388
1564,대원화성,024890,inf,-2.8,2324,2068,4392
759,메디포스트,078160,inf,-1.66,2092,2302,4394
2142,GS,078930,inf,-2.81,2330,2067,4397
1408,시너지이노베이션,048870,inf,-27.76,2419,1980,4399
1565,대유에이텍,002880,inf,-1.86,2108,2293,4401
790,쎄노텍,222420,inf,-22.79,2374,2028,4402
2147,KH 필룩스,033180,inf,-17.37,2263,2145,4408
1697,비피도,238200,inf,-1.22,2091,2320,4411
1628,핸즈코퍼레이션,143210,inf,-2.51,2336,2080,4416
277,휴맥스,115160,inf,-24.36,2404,2014,4418
1092,신원종합개발,017000,inf,-17.68,2285,2137,4422
1585,세원이앤씨,091090,inf,-15.32,2248,2176,4424
2219,체시스,033250,inf,-16.17,2262,2162,4424
2225,한국가스공사,036460,inf,-2.24,2331,2093,4424
631,동양,001520,inf,-2.92,2362,2063,4425
1033,나노,187790,inf,-16.28,2270,2161,4431
424,디엠티,134580,inf,-19.05,2310,2121,4431
234,케이티알파,036030,inf,-2.1,2332,2100,4432
388,CBI,013720,inf,-14.48,2245,2191,4436
1428,에이아이비트,039230,inf,-16.41,2280,2159,4439
1069,바른손,018700,inf,-19.83,2334,2109,4443
1681,미디어젠,279600,inf,-2.02,2340,2104,4444
873,테라셈,182690,inf,-16.47,2290,2155,4445
226,조아제약,034940,inf,-2.37,2360,2088,4448
445,박셀바이오,323990,inf,-18.22,2323,2128,4451
1506,폴라리스오피스,041020,inf,-0.35,2094,2359,4453
1040,뉴프렉스,085670,inf,-21.42,2415,2039,4454
1266,세아베스틸,001430,inf,-14.18,2258,2196,4454
1111,에이스테크,088800,inf,-103.89,2187,2268,4455
1687,바텍,043150,inf,-10.28,2169,2286,4455
514,이지케어텍,099750,inf,-21.01,2411,2044,4455
352,유니온머티리얼,047400,inf,-1.59,2151,2305,4456
1024,SM C&C,048550,inf,-12.93,2228,2229,4457
1384,배럴,267790,inf,-14.43,2266,2192,4458
539,코드네이처,078940,inf,-17.01,2311,2147,4458
1405,수성이노베이션,084180,inf,-18.29,2348,2126,4474
213,이스트아시아홀딩스,900110,inf,-0.46,2118,2356,4474
736,대명소노시즌,007720,inf,-2.56,2402,2076,4478
1466,이오플로우,294090,inf,-138.74,2281,2198,4479
788,신테카바이오,226330,inf,-14.8,2296,2185,4481
870,코이즈,121850,inf,-14.25,2287,2195,4482
459,상지카일룸,042940,inf,-13.7,2277,2211,4488
422,디딤,217620,inf,-147.73,2308,2181,4489
2218,천일고속,000650,inf,-15.21,2314,2177,4491
1519,홈캐스트,064240,inf,-2.49,2409,2083,4492
1083,서진오토모티브,122690,inf,-17.41,2352,2144,4496
1105,액션스퀘어,205500,inf,-10.46,2216,2281,4497
728,나무가,190510,inf,-19.1,2381,2120,4501
1407,스킨앤스킨,159910,inf,-112.19,2257,2245,4502
821,엘컴텍,037950,inf,-16.97,2353,2150,4503
474,아가방컴퍼니,013990,inf,-1.47,2195,2309,4504
1226,LG디스플레이,034220,inf,-0.79,2164,2343,4507
754,로보스타,090360,inf,-14.67,2319,2188,4507
426,딜리,131180,inf,-0.99,2178,2331,4509
1369,디지탈옵틱,106520,inf,-166.02,2361,2149,4510
466,솔루에타,154040,inf,-16.64,2359,2152,4511
252,파커스,065690,inf,-10.56,2237,2277,4514
1478,제이웨이,058420,inf,-159.36,2354,2165,4519
840,이랜텍,054210,inf,-10.3,2235,2285,4520
1017,EG,037370,inf,-10.36,2238,2282,4520
486,에프알텍,073540,inf,-13.29,2306,2216,4522
571,하나마이크론,067310,inf,-11.81,2272,2251,4523
1089,스타플렉스,115570,inf,-10.63,2247,2276,4523
757,맥스로텍,141070,inf,-121.17,2298,2228,4526
484,에스엘바이오닉스,214310,inf,-0.55,2176,2352,4528
760,미래컴퍼니,049950,inf,-13.81,2325,2206,4531
530,지니틱스,303030,inf,-0.87,2198,2337,4535
178,에쎈테크,043340,inf,-1.36,2221,2314,4535
1055,레인보우로보틱스,277810,,-19.27,2424,2117,4541
1440,엘엠에스,073110,inf,-16.44,2387,2156,4543
783,스카이이앤엠,131100,inf,-102.21,2273,2270,4543
1592,유성기업,002920,inf,-1.75,2254,2298,4552
781,슈펙스비앤피,058530,inf,-12.47,2317,2235,4552
14,WISCOM,024070,inf,-0.85,2224,2339,4563
1192,한국유니온제약,080720,inf,-14.75,2377,2186,4563
2295,버킷스튜디오,066410,inf,-11.35,2305,2258,4563
1690,블루콤,033560,inf,-0.31,2203,2361,4564
605,SBS,034120,inf,-12.32,2335,2236,4571
2354,엠투엔,033310,inf,-10.87,2303,2274,4577
1149,이트론,096040,inf,-13.31,2369,2215,4584
581,휴맥스홀딩스,028080,inf,-15.48,2412,2173,4585
2430,한국정보공학,039740,inf,-10.18,2302,2287,4589
836,이건홀딩스,039020,inf,-0.12,2229,2366,4595
1065,모베이스전자,012860,inf,-11.64,2345,2253,4598
1305,하나투어,039130,inf,-108.93,2333,2266,4599
473,씨티케이,260930,inf,-0.27,2244,2362,4606
1091,시노펙스,025320,inf,-11.27,2347,2260,4607
349,영진약품,003520,inf,-0.12,2250,2367,4617
979,우신시스템,017370,inf,-11.2,2372,2261,4633
846,인터파크,035080,inf,-10.72,2363,2275,4638
848,자이언트스텝,289220,,-13.13,2423,2218,4641
1988,뷰노,338220,,-1250.52,2422,2224,4646
61,인지컨트롤스,023800,inf,-1.77,2364,2296,4660
1112,에이치엠씨제5호스팩,353060,inf,,2421,2447,4868
1019,IBKS제15호스팩,373200,,,2448,2448,4896
1093,신한제7호스팩,366330,,,2449,2449,4898
1116,엔시스,333620,,,2450,2450,4900
1324,DB금융스팩9호,367360,,,2451,2451,4902
1804,하나금융17호스팩,363260,,,2452,2452,4904
1805,하나머스트7호스팩,372290,,,2453,2453,4906
2105,한국9호스팩,368770,,,2454,2454,4908
