,name,code,per,roe,per_sort,roe_sort,sort
4,KEC,092220,-24.43,-7.56,2,0,2
2,GS글로벌,001250,-24.91,-1.99,1,1,2
10,LG헬로비전,037560,-39.53,-0.96,0,2,2
1,DSR,155660,5.67,11.2,5,5,10
7,KTis,058860,4.4,12.13,4,6,10
3,HDC현대산업개발,294870,8.85,7.26,7,4,11
6,KG케미칼,001390,11.94,7.19,9,3,12
0,DRB동일,004840,0.66,58.97,3,10,13
5,KG동부제철,016380,7.18,17.37,6,8,14
9,LG전자,066570,13.23,12.4,10,7,17
8,LG이노텍,011070,10.2,18.29,8,9,17
